Ccap_prd_B4_o01	cctcaacctacctccaacaaACCTAATTGATTGACGCGACCCTGG
Ccap_prd_B4_e01	CAATGGACGACCGTTTATGAACACAtctcaccatattcgcttcat
Ccap_prd_B4_o02	cctcaacctacctccaacaaGATATAACACACGGTCGGATACCTT
Ccap_prd_B4_e02	CAACCGTGTGAAACACGCAACTGTCtctcaccatattcgcttcat
Ccap_prd_B4_o03	cctcaacctacctccaacaaACCCGCCAATAACACCCGGCCGTAT
Ccap_prd_B4_e03	TTTCTGGTGTAGCTATACGTGGCTTtctcaccatattcgcttcat
Ccap_prd_B4_o04	cctcaacctacctccaacaaCCATCGCGTATCAGTTTATCTCTTA
Ccap_prd_B4_e04	GATGGTGCAGTTGTGCGATCACATAtctcaccatattcgcttcat
Ccap_prd_B4_o05	cctcaacctacctccaacaaGTGTTTTCTGCACATCATCATCGTT
Ccap_prd_B4_e05	GCTTGTGGGAATGTTCTGAGCCGGAtctcaccatattcgcttcat
Ccap_prd_B4_o06	cctcaacctacctccaacaaACGCTGTTTACGTTTCAACGCTATG
Ccap_prd_B4_e06	CATGGCTGTGAAGGTAGTGCGACTGtctcaccatattcgcttcat
Ccap_prd_B4_o07	cctcaacctacctccaacaaCTCTTCGCGTGTATAAATATCTGGA
Ccap_prd_B4_e07	TTCCGAGAGATTTGTGCGTTGCGCCtctcaccatattcgcttcat
Ccap_prd_B4_o08	cctcaacctacctccaacaaGAGCCGGAAGTATTCTGCTTACGCA
Ccap_prd_B4_e08	CCATTAACGCTGCCGCTGCTCGTCGtctcaccatattcgcttcat
Ccap_prd_B4_o09	cctcaacctacctccaacaaCCGCGGCAGCTGCTGCAACTGGTGG
Ccap_prd_B4_e09	CGGCTGCTGCTGCATAATTATTCGCtctcaccatattcgcttcat
Ccap_prd_B4_o10	cctcaacctacctccaacaaTTGTTGATATGCTGCTGCCATTGCC
Ccap_prd_B4_e10	ATGTCCTGCATAGAAGTCGTACACTtctcaccatattcgcttcat
Ccap_prd_B4_o11	cctcaacctacctccaacaaTGTGGATAAGTTGTAGTTCGCAGCG
Ccap_prd_B4_e11	CGCACCATTACTTATGGTTAGGTTAtctcaccatattcgcttcat
Ccap_prd_B4_o12	cctcaacctacctccaacaaTATTGCGATTGTAGTGTTGCACTCA
Ccap_prd_B4_e12	GCGCGCATTAATGGCGAAATAGATTtctcaccatattcgcttcat
Ccap_prd_B4_o13	cctcaacctacctccaacaaGATTATTAACTCCTTGGCAGAGACT
Ccap_prd_B4_e13	CCGCTGCAGTTGTATAGTTCAGATTtctcaccatattcgcttcat
Ccap_prd_B4_o14	cctcaacctacctccaacaaAAAGGAGGGCGAAACCGACTCATTG
Ccap_prd_B4_e14	TATGCCACTATTGTTGGCATTACTGtctcaccatattcgcttcat
Ccap_prd_B4_o15	cctcaacctacctccaacaaTCTAATTCATCAGATGGGTTGCCGC
Ccap_prd_B4_e15	TGTTGTGATTCGCTTTTAATCCCACtctcaccatattcgcttcat
Ccap_prd_B4_o16	cctcaacctacctccaacaaGTTGTTGTTGCTGTTGTTGTGATTG
Ccap_prd_B4_e16	TGGCATTTGTAGACAGTTGGTGTTGtctcaccatattcgcttcat
Ccap_prd_B4_o17	cctcaacctacctccaacaaGGCTACTTGAGACGAGCTGGAGTTT
Ccap_prd_B4_e17	ATGGAACATCATATGCGCCGTCGCAtctcaccatattcgcttcat
Ccap_prd_B4_o18	cctcaacctacctccaacaaGTATGGAAGGATGGTGGCGTCGGTG
Ccap_prd_B4_e18	TGATGATGCGCATGTGCATGTGTATtctcaccatattcgcttcat
Ccap_prd_B4_o19	cctcaacctacctccaacaaCCGCAGACGTGCTGTGATGGAAGCC
Ccap_prd_B4_e19	CAGCGTTCGTGCTAGAGCTCATGTTtctcaccatattcgcttcat
Ccap_prd_B4_o20	cctcaacctacctccaacaaGGATAATTCATTTTCGATGGCGAAC
Ccap_prd_B4_e20	GAAGGATAGAAGGGCTGCGGCACTGtctcaccatattcgcttcat
