Ccap_prd_B3_o01	gtccctgcctctatatctttACCTAATTGATTGACGCGACCCTGG
Ccap_prd_B3_e01	CAATGGACGACCGTTTATGAACACAccactcaactttaacccgtt
Ccap_prd_B3_o02	gtccctgcctctatatctttGATATAACACACGGTCGGATACCTT
Ccap_prd_B3_e02	CAACCGTGTGAAACACGCAACTGTCccactcaactttaacccgtt
Ccap_prd_B3_o03	gtccctgcctctatatctttACCCGCCAATAACACCCGGCCGTAT
Ccap_prd_B3_e03	TTTCTGGTGTAGCTATACGTGGCTTccactcaactttaacccgtt
Ccap_prd_B3_o04	gtccctgcctctatatctttCCATCGCGTATCAGTTTATCTCTTA
Ccap_prd_B3_e04	GATGGTGCAGTTGTGCGATCACATAccactcaactttaacccgtt
Ccap_prd_B3_o05	gtccctgcctctatatctttGTGTTTTCTGCACATCATCATCGTT
Ccap_prd_B3_e05	GCTTGTGGGAATGTTCTGAGCCGGAccactcaactttaacccgtt
Ccap_prd_B3_o06	gtccctgcctctatatctttACGCTGTTTACGTTTCAACGCTATG
Ccap_prd_B3_e06	CATGGCTGTGAAGGTAGTGCGACTGccactcaactttaacccgtt
Ccap_prd_B3_o07	gtccctgcctctatatctttCTCTTCGCGTGTATAAATATCTGGA
Ccap_prd_B3_e07	TTCCGAGAGATTTGTGCGTTGCGCCccactcaactttaacccgtt
Ccap_prd_B3_o08	gtccctgcctctatatctttGAGCCGGAAGTATTCTGCTTACGCA
Ccap_prd_B3_e08	CCATTAACGCTGCCGCTGCTCGTCGccactcaactttaacccgtt
Ccap_prd_B3_o09	gtccctgcctctatatctttCCGCGGCAGCTGCTGCAACTGGTGG
Ccap_prd_B3_e09	CGGCTGCTGCTGCATAATTATTCGCccactcaactttaacccgtt
Ccap_prd_B3_o10	gtccctgcctctatatctttTTGTTGATATGCTGCTGCCATTGCC
Ccap_prd_B3_e10	ATGTCCTGCATAGAAGTCGTACACTccactcaactttaacccgtt
Ccap_prd_B3_o11	gtccctgcctctatatctttTGTGGATAAGTTGTAGTTCGCAGCG
Ccap_prd_B3_e11	CGCACCATTACTTATGGTTAGGTTAccactcaactttaacccgtt
Ccap_prd_B3_o12	gtccctgcctctatatctttTATTGCGATTGTAGTGTTGCACTCA
Ccap_prd_B3_e12	GCGCGCATTAATGGCGAAATAGATTccactcaactttaacccgtt
Ccap_prd_B3_o13	gtccctgcctctatatctttGATTATTAACTCCTTGGCAGAGACT
Ccap_prd_B3_e13	CCGCTGCAGTTGTATAGTTCAGATTccactcaactttaacccgtt
Ccap_prd_B3_o14	gtccctgcctctatatctttAAAGGAGGGCGAAACCGACTCATTG
Ccap_prd_B3_e14	TATGCCACTATTGTTGGCATTACTGccactcaactttaacccgtt
Ccap_prd_B3_o15	gtccctgcctctatatctttTCTAATTCATCAGATGGGTTGCCGC
Ccap_prd_B3_e15	TGTTGTGATTCGCTTTTAATCCCACccactcaactttaacccgtt
Ccap_prd_B3_o16	gtccctgcctctatatctttGTTGTTGTTGCTGTTGTTGTGATTG
Ccap_prd_B3_e16	TGGCATTTGTAGACAGTTGGTGTTGccactcaactttaacccgtt
Ccap_prd_B3_o17	gtccctgcctctatatctttGGCTACTTGAGACGAGCTGGAGTTT
Ccap_prd_B3_e17	ATGGAACATCATATGCGCCGTCGCAccactcaactttaacccgtt
Ccap_prd_B3_o18	gtccctgcctctatatctttGTATGGAAGGATGGTGGCGTCGGTG
Ccap_prd_B3_e18	TGATGATGCGCATGTGCATGTGTATccactcaactttaacccgtt
Ccap_prd_B3_o19	gtccctgcctctatatctttCCGCAGACGTGCTGTGATGGAAGCC
Ccap_prd_B3_e19	CAGCGTTCGTGCTAGAGCTCATGTTccactcaactttaacccgtt
Ccap_prd_B3_o20	gtccctgcctctatatctttGGATAATTCATTTTCGATGGCGAAC
Ccap_prd_B3_e20	GAAGGATAGAAGGGCTGCGGCACTGccactcaactttaacccgtt
