Ccap_prd_B1_o01	gaggagggcagcaaacggaaACCTAATTGATTGACGCGACCCTGG
Ccap_prd_B1_e01	CAATGGACGACCGTTTATGAACACAgaagagtcttcctttacgta
Ccap_prd_B1_o02	gaggagggcagcaaacggaaGATATAACACACGGTCGGATACCTT
Ccap_prd_B1_e02	CAACCGTGTGAAACACGCAACTGTCgaagagtcttcctttacgta
Ccap_prd_B1_o03	gaggagggcagcaaacggaaACCCGCCAATAACACCCGGCCGTAT
Ccap_prd_B1_e03	TTTCTGGTGTAGCTATACGTGGCTTgaagagtcttcctttacgta
Ccap_prd_B1_o04	gaggagggcagcaaacggaaCCATCGCGTATCAGTTTATCTCTTA
Ccap_prd_B1_e04	GATGGTGCAGTTGTGCGATCACATAgaagagtcttcctttacgta
Ccap_prd_B1_o05	gaggagggcagcaaacggaaGTGTTTTCTGCACATCATCATCGTT
Ccap_prd_B1_e05	GCTTGTGGGAATGTTCTGAGCCGGAgaagagtcttcctttacgta
Ccap_prd_B1_o06	gaggagggcagcaaacggaaACGCTGTTTACGTTTCAACGCTATG
Ccap_prd_B1_e06	CATGGCTGTGAAGGTAGTGCGACTGgaagagtcttcctttacgta
Ccap_prd_B1_o07	gaggagggcagcaaacggaaCTCTTCGCGTGTATAAATATCTGGA
Ccap_prd_B1_e07	TTCCGAGAGATTTGTGCGTTGCGCCgaagagtcttcctttacgta
Ccap_prd_B1_o08	gaggagggcagcaaacggaaGAGCCGGAAGTATTCTGCTTACGCA
Ccap_prd_B1_e08	CCATTAACGCTGCCGCTGCTCGTCGgaagagtcttcctttacgta
Ccap_prd_B1_o09	gaggagggcagcaaacggaaCCGCGGCAGCTGCTGCAACTGGTGG
Ccap_prd_B1_e09	CGGCTGCTGCTGCATAATTATTCGCgaagagtcttcctttacgta
Ccap_prd_B1_o10	gaggagggcagcaaacggaaTTGTTGATATGCTGCTGCCATTGCC
Ccap_prd_B1_e10	ATGTCCTGCATAGAAGTCGTACACTgaagagtcttcctttacgta
Ccap_prd_B1_o11	gaggagggcagcaaacggaaTGTGGATAAGTTGTAGTTCGCAGCG
Ccap_prd_B1_e11	CGCACCATTACTTATGGTTAGGTTAgaagagtcttcctttacgta
Ccap_prd_B1_o12	gaggagggcagcaaacggaaTATTGCGATTGTAGTGTTGCACTCA
Ccap_prd_B1_e12	GCGCGCATTAATGGCGAAATAGATTgaagagtcttcctttacgta
Ccap_prd_B1_o13	gaggagggcagcaaacggaaGATTATTAACTCCTTGGCAGAGACT
Ccap_prd_B1_e13	CCGCTGCAGTTGTATAGTTCAGATTgaagagtcttcctttacgta
Ccap_prd_B1_o14	gaggagggcagcaaacggaaAAAGGAGGGCGAAACCGACTCATTG
Ccap_prd_B1_e14	TATGCCACTATTGTTGGCATTACTGgaagagtcttcctttacgta
Ccap_prd_B1_o15	gaggagggcagcaaacggaaTCTAATTCATCAGATGGGTTGCCGC
Ccap_prd_B1_e15	TGTTGTGATTCGCTTTTAATCCCACgaagagtcttcctttacgta
Ccap_prd_B1_o16	gaggagggcagcaaacggaaGTTGTTGTTGCTGTTGTTGTGATTG
Ccap_prd_B1_e16	TGGCATTTGTAGACAGTTGGTGTTGgaagagtcttcctttacgta
Ccap_prd_B1_o17	gaggagggcagcaaacggaaGGCTACTTGAGACGAGCTGGAGTTT
Ccap_prd_B1_e17	ATGGAACATCATATGCGCCGTCGCAgaagagtcttcctttacgta
Ccap_prd_B1_o18	gaggagggcagcaaacggaaGTATGGAAGGATGGTGGCGTCGGTG
Ccap_prd_B1_e18	TGATGATGCGCATGTGCATGTGTATgaagagtcttcctttacgta
Ccap_prd_B1_o19	gaggagggcagcaaacggaaCCGCAGACGTGCTGTGATGGAAGCC
Ccap_prd_B1_e19	CAGCGTTCGTGCTAGAGCTCATGTTgaagagtcttcctttacgta
Ccap_prd_B1_o20	gaggagggcagcaaacggaaGGATAATTCATTTTCGATGGCGAAC
Ccap_prd_B1_e20	GAAGGATAGAAGGGCTGCGGCACTGgaagagtcttcctttacgta
