Ccap_prd_B2_o01	cctcgtaaatcctcatcaaaACCTAATTGATTGACGCGACCCTGG
Ccap_prd_B2_e01	CAATGGACGACCGTTTATGAACACAatcatccagtaaaccgccaa
Ccap_prd_B2_o02	cctcgtaaatcctcatcaaaGATATAACACACGGTCGGATACCTT
Ccap_prd_B2_e02	CAACCGTGTGAAACACGCAACTGTCatcatccagtaaaccgccaa
Ccap_prd_B2_o03	cctcgtaaatcctcatcaaaACCCGCCAATAACACCCGGCCGTAT
Ccap_prd_B2_e03	TTTCTGGTGTAGCTATACGTGGCTTatcatccagtaaaccgccaa
Ccap_prd_B2_o04	cctcgtaaatcctcatcaaaCCATCGCGTATCAGTTTATCTCTTA
Ccap_prd_B2_e04	GATGGTGCAGTTGTGCGATCACATAatcatccagtaaaccgccaa
Ccap_prd_B2_o05	cctcgtaaatcctcatcaaaGTGTTTTCTGCACATCATCATCGTT
Ccap_prd_B2_e05	GCTTGTGGGAATGTTCTGAGCCGGAatcatccagtaaaccgccaa
Ccap_prd_B2_o06	cctcgtaaatcctcatcaaaACGCTGTTTACGTTTCAACGCTATG
Ccap_prd_B2_e06	CATGGCTGTGAAGGTAGTGCGACTGatcatccagtaaaccgccaa
Ccap_prd_B2_o07	cctcgtaaatcctcatcaaaCTCTTCGCGTGTATAAATATCTGGA
Ccap_prd_B2_e07	TTCCGAGAGATTTGTGCGTTGCGCCatcatccagtaaaccgccaa
Ccap_prd_B2_o08	cctcgtaaatcctcatcaaaGAGCCGGAAGTATTCTGCTTACGCA
Ccap_prd_B2_e08	CCATTAACGCTGCCGCTGCTCGTCGatcatccagtaaaccgccaa
Ccap_prd_B2_o09	cctcgtaaatcctcatcaaaCCGCGGCAGCTGCTGCAACTGGTGG
Ccap_prd_B2_e09	CGGCTGCTGCTGCATAATTATTCGCatcatccagtaaaccgccaa
Ccap_prd_B2_o10	cctcgtaaatcctcatcaaaTTGTTGATATGCTGCTGCCATTGCC
Ccap_prd_B2_e10	ATGTCCTGCATAGAAGTCGTACACTatcatccagtaaaccgccaa
Ccap_prd_B2_o11	cctcgtaaatcctcatcaaaTGTGGATAAGTTGTAGTTCGCAGCG
Ccap_prd_B2_e11	CGCACCATTACTTATGGTTAGGTTAatcatccagtaaaccgccaa
Ccap_prd_B2_o12	cctcgtaaatcctcatcaaaTATTGCGATTGTAGTGTTGCACTCA
Ccap_prd_B2_e12	GCGCGCATTAATGGCGAAATAGATTatcatccagtaaaccgccaa
Ccap_prd_B2_o13	cctcgtaaatcctcatcaaaGATTATTAACTCCTTGGCAGAGACT
Ccap_prd_B2_e13	CCGCTGCAGTTGTATAGTTCAGATTatcatccagtaaaccgccaa
Ccap_prd_B2_o14	cctcgtaaatcctcatcaaaAAAGGAGGGCGAAACCGACTCATTG
Ccap_prd_B2_e14	TATGCCACTATTGTTGGCATTACTGatcatccagtaaaccgccaa
Ccap_prd_B2_o15	cctcgtaaatcctcatcaaaTCTAATTCATCAGATGGGTTGCCGC
Ccap_prd_B2_e15	TGTTGTGATTCGCTTTTAATCCCACatcatccagtaaaccgccaa
Ccap_prd_B2_o16	cctcgtaaatcctcatcaaaGTTGTTGTTGCTGTTGTTGTGATTG
Ccap_prd_B2_e16	TGGCATTTGTAGACAGTTGGTGTTGatcatccagtaaaccgccaa
Ccap_prd_B2_o17	cctcgtaaatcctcatcaaaGGCTACTTGAGACGAGCTGGAGTTT
Ccap_prd_B2_e17	ATGGAACATCATATGCGCCGTCGCAatcatccagtaaaccgccaa
Ccap_prd_B2_o18	cctcgtaaatcctcatcaaaGTATGGAAGGATGGTGGCGTCGGTG
Ccap_prd_B2_e18	TGATGATGCGCATGTGCATGTGTATatcatccagtaaaccgccaa
Ccap_prd_B2_o19	cctcgtaaatcctcatcaaaCCGCAGACGTGCTGTGATGGAAGCC
Ccap_prd_B2_e19	CAGCGTTCGTGCTAGAGCTCATGTTatcatccagtaaaccgccaa
Ccap_prd_B2_o20	cctcgtaaatcctcatcaaaGGATAATTCATTTTCGATGGCGAAC
Ccap_prd_B2_e20	GAAGGATAGAAGGGCTGCGGCACTGatcatccagtaaaccgccaa
