Ccap_prd_B5_o01	ctcactcccaatctctataaACCTAATTGATTGACGCGACCCTGG
Ccap_prd_B5_e01	CAATGGACGACCGTTTATGAACACActaccctacaaatccaataa
Ccap_prd_B5_o02	ctcactcccaatctctataaGATATAACACACGGTCGGATACCTT
Ccap_prd_B5_e02	CAACCGTGTGAAACACGCAACTGTCctaccctacaaatccaataa
Ccap_prd_B5_o03	ctcactcccaatctctataaACCCGCCAATAACACCCGGCCGTAT
Ccap_prd_B5_e03	TTTCTGGTGTAGCTATACGTGGCTTctaccctacaaatccaataa
Ccap_prd_B5_o04	ctcactcccaatctctataaCCATCGCGTATCAGTTTATCTCTTA
Ccap_prd_B5_e04	GATGGTGCAGTTGTGCGATCACATActaccctacaaatccaataa
Ccap_prd_B5_o05	ctcactcccaatctctataaGTGTTTTCTGCACATCATCATCGTT
Ccap_prd_B5_e05	GCTTGTGGGAATGTTCTGAGCCGGActaccctacaaatccaataa
Ccap_prd_B5_o06	ctcactcccaatctctataaACGCTGTTTACGTTTCAACGCTATG
Ccap_prd_B5_e06	CATGGCTGTGAAGGTAGTGCGACTGctaccctacaaatccaataa
Ccap_prd_B5_o07	ctcactcccaatctctataaCTCTTCGCGTGTATAAATATCTGGA
Ccap_prd_B5_e07	TTCCGAGAGATTTGTGCGTTGCGCCctaccctacaaatccaataa
Ccap_prd_B5_o08	ctcactcccaatctctataaGAGCCGGAAGTATTCTGCTTACGCA
Ccap_prd_B5_e08	CCATTAACGCTGCCGCTGCTCGTCGctaccctacaaatccaataa
Ccap_prd_B5_o09	ctcactcccaatctctataaCCGCGGCAGCTGCTGCAACTGGTGG
Ccap_prd_B5_e09	CGGCTGCTGCTGCATAATTATTCGCctaccctacaaatccaataa
Ccap_prd_B5_o10	ctcactcccaatctctataaTTGTTGATATGCTGCTGCCATTGCC
Ccap_prd_B5_e10	ATGTCCTGCATAGAAGTCGTACACTctaccctacaaatccaataa
Ccap_prd_B5_o11	ctcactcccaatctctataaTGTGGATAAGTTGTAGTTCGCAGCG
Ccap_prd_B5_e11	CGCACCATTACTTATGGTTAGGTTActaccctacaaatccaataa
Ccap_prd_B5_o12	ctcactcccaatctctataaTATTGCGATTGTAGTGTTGCACTCA
Ccap_prd_B5_e12	GCGCGCATTAATGGCGAAATAGATTctaccctacaaatccaataa
Ccap_prd_B5_o13	ctcactcccaatctctataaGATTATTAACTCCTTGGCAGAGACT
Ccap_prd_B5_e13	CCGCTGCAGTTGTATAGTTCAGATTctaccctacaaatccaataa
Ccap_prd_B5_o14	ctcactcccaatctctataaAAAGGAGGGCGAAACCGACTCATTG
Ccap_prd_B5_e14	TATGCCACTATTGTTGGCATTACTGctaccctacaaatccaataa
Ccap_prd_B5_o15	ctcactcccaatctctataaTCTAATTCATCAGATGGGTTGCCGC
Ccap_prd_B5_e15	TGTTGTGATTCGCTTTTAATCCCACctaccctacaaatccaataa
Ccap_prd_B5_o16	ctcactcccaatctctataaGTTGTTGTTGCTGTTGTTGTGATTG
Ccap_prd_B5_e16	TGGCATTTGTAGACAGTTGGTGTTGctaccctacaaatccaataa
Ccap_prd_B5_o17	ctcactcccaatctctataaGGCTACTTGAGACGAGCTGGAGTTT
Ccap_prd_B5_e17	ATGGAACATCATATGCGCCGTCGCActaccctacaaatccaataa
Ccap_prd_B5_o18	ctcactcccaatctctataaGTATGGAAGGATGGTGGCGTCGGTG
Ccap_prd_B5_e18	TGATGATGCGCATGTGCATGTGTATctaccctacaaatccaataa
Ccap_prd_B5_o19	ctcactcccaatctctataaCCGCAGACGTGCTGTGATGGAAGCC
Ccap_prd_B5_e19	CAGCGTTCGTGCTAGAGCTCATGTTctaccctacaaatccaataa
Ccap_prd_B5_o20	ctcactcccaatctctataaGGATAATTCATTTTCGATGGCGAAC
Ccap_prd_B5_e20	GAAGGATAGAAGGGCTGCGGCACTGctaccctacaaatccaataa
