Ccap_btd_B5_o01	ctcactcccaatctctataaGTCAATAGTTCAAGATGTTGTGCGA
Ccap_btd_B5_e01	TTTGAGTGATGAACTCAGTGTCGAActaccctacaaatccaataa
Ccap_btd_B5_o02	ctcactcccaatctctataaGACTGAGTGTGTGTACGCGTTGTTT
Ccap_btd_B5_e02	GTACGAAGAGGTTTTGCTTCAACAActaccctacaaatccaataa
Ccap_btd_B5_o03	ctcactcccaatctctataaTACCAGCTAAGCACTGTATTTCATG
Ccap_btd_B5_e03	ACAGAGTGTTTGTCTGTTTGTTTGCctaccctacaaatccaataa
Ccap_btd_B5_o04	ctcactcccaatctctataaCACTGCCCAAAATGTACACAAATTC
Ccap_btd_B5_e04	GCTTTGCTCGTTGGTTATAAAACTGctaccctacaaatccaataa
Ccap_btd_B5_o05	ctcactcccaatctctataaTTGCACTAGAACTGCCGTTGGGAAC
Ccap_btd_B5_e05	GGGTGCAGTATATAATTAAGCGTTCctaccctacaaatccaataa
Ccap_btd_B5_o06	ctcactcccaatctctataaGCAGCTTCTGCTAACACTTTTGATA
Ccap_btd_B5_e06	TCGACTTGTCCAAAATGATGGATGGctaccctacaaatccaataa
Ccap_btd_B5_o07	ctcactcccaatctctataaTATTAACTGGCGGCATACTTGCGGC
Ccap_btd_B5_e07	GCTGTGACTGGTGATATTGATTGTTctaccctacaaatccaataa
Ccap_btd_B5_o08	ctcactcccaatctctataaTGTGATGCTGTATTTGGGGATTTCT
Ccap_btd_B5_e08	TTCATTCCAAGTGCACCACCTGCTActaccctacaaatccaataa
Ccap_btd_B5_o09	ctcactcccaatctctataaCGGCGATACTGATGATGATGTTGCC
Ccap_btd_B5_e09	GTGTATAGAGTTTGGCGAGCCGGAActaccctacaaatccaataa
Ccap_btd_B5_o10	ctcactcccaatctctataaTATAGTATTCCGGCGCATATTGAGC
Ccap_btd_B5_e10	GCTCTTGTGAAAACCAGGCGCTGTTctaccctacaaatccaataa
Ccap_btd_B5_o11	ctcactcccaatctctataaATATGTTGTTTGCGACCACGTTCGT
Ccap_btd_B5_e11	AACCGTTCACAGCCAGGTATATGACctaccctacaaatccaataa
Ccap_btd_B5_o12	ctcactcccaatctctataaGGCTGCAAGTTCTTTCTTGGTTTTT
Ccap_btd_B5_e12	GGGTGAAGCATTTTGCTGCTTCGCTctaccctacaaatccaataa
Ccap_btd_B5_o13	ctcactcccaatctctataaAAACAGTAGCTGGGTCAGGCGATTT
Ccap_btd_B5_e13	ACATAGGCAGCGAGCGTCGGGCCGCctaccctacaaatccaataa
Ccap_btd_B5_o14	ctcactcccaatctctataaGCGGATGTGCCTGGTTGTTGCTCAT
Ccap_btd_B5_e14	ATAGGTGAAGCGGACGTTACGTAGGctaccctacaaatccaataa
Ccap_btd_B5_o15	ctcactcccaatctctataaCTGTTAGTTACAGGACTCGAAAGCA
Ccap_btd_B5_e15	GTTGTTGAGGTAGTTTCATTGTTGGctaccctacaaatccaataa
Ccap_btd_B5_o16	ctcactcccaatctctataaGCCAGGTGAGCCCATGATGAGACCA
Ccap_btd_B5_e16	TACTGGTGAGGGTGAGCTATTGGAGctaccctacaaatccaataa
Ccap_btd_B5_o17	ctcactcccaatctctataaGTTGGTATGCGGCTGCAGTAGCCCA
Ccap_btd_B5_e17	GCACTCTTCAAGCCGTGGCGTGTGActaccctacaaatccaataa
Ccap_btd_B5_o18	ctcactcccaatctctataaCGAACAAACAGGACACACAATAATG
Ccap_btd_B5_e18	GCCCACTCAGCTCAGCTCTCTTAACctaccctacaaatccaataa
Ccap_btd_B5_o19	ctcactcccaatctctataaATTAAGGGGGGATGAAAATCAGTGG
Ccap_btd_B5_e19	CAGCAAGTTCTTTAGTGTGAACGTActaccctacaaatccaataa
Ccap_btd_B5_o20	ctcactcccaatctctataaATTTATGAGCAACACCAAGGCGCCA
Ccap_btd_B5_e20	GAACGCCTAATTTGCTAAAACCATCctaccctacaaatccaataa
