Ccap_btd_B1_o01	gaggagggcagcaaacggaaGTCAATAGTTCAAGATGTTGTGCGA
Ccap_btd_B1_e01	TTTGAGTGATGAACTCAGTGTCGAAgaagagtcttcctttacgta
Ccap_btd_B1_o02	gaggagggcagcaaacggaaGACTGAGTGTGTGTACGCGTTGTTT
Ccap_btd_B1_e02	GTACGAAGAGGTTTTGCTTCAACAAgaagagtcttcctttacgta
Ccap_btd_B1_o03	gaggagggcagcaaacggaaTACCAGCTAAGCACTGTATTTCATG
Ccap_btd_B1_e03	ACAGAGTGTTTGTCTGTTTGTTTGCgaagagtcttcctttacgta
Ccap_btd_B1_o04	gaggagggcagcaaacggaaCACTGCCCAAAATGTACACAAATTC
Ccap_btd_B1_e04	GCTTTGCTCGTTGGTTATAAAACTGgaagagtcttcctttacgta
Ccap_btd_B1_o05	gaggagggcagcaaacggaaTTGCACTAGAACTGCCGTTGGGAAC
Ccap_btd_B1_e05	GGGTGCAGTATATAATTAAGCGTTCgaagagtcttcctttacgta
Ccap_btd_B1_o06	gaggagggcagcaaacggaaGCAGCTTCTGCTAACACTTTTGATA
Ccap_btd_B1_e06	TCGACTTGTCCAAAATGATGGATGGgaagagtcttcctttacgta
Ccap_btd_B1_o07	gaggagggcagcaaacggaaTATTAACTGGCGGCATACTTGCGGC
Ccap_btd_B1_e07	GCTGTGACTGGTGATATTGATTGTTgaagagtcttcctttacgta
Ccap_btd_B1_o08	gaggagggcagcaaacggaaTGTGATGCTGTATTTGGGGATTTCT
Ccap_btd_B1_e08	TTCATTCCAAGTGCACCACCTGCTAgaagagtcttcctttacgta
Ccap_btd_B1_o09	gaggagggcagcaaacggaaCGGCGATACTGATGATGATGTTGCC
Ccap_btd_B1_e09	GTGTATAGAGTTTGGCGAGCCGGAAgaagagtcttcctttacgta
Ccap_btd_B1_o10	gaggagggcagcaaacggaaTATAGTATTCCGGCGCATATTGAGC
Ccap_btd_B1_e10	GCTCTTGTGAAAACCAGGCGCTGTTgaagagtcttcctttacgta
Ccap_btd_B1_o11	gaggagggcagcaaacggaaATATGTTGTTTGCGACCACGTTCGT
Ccap_btd_B1_e11	AACCGTTCACAGCCAGGTATATGACgaagagtcttcctttacgta
Ccap_btd_B1_o12	gaggagggcagcaaacggaaGGCTGCAAGTTCTTTCTTGGTTTTT
Ccap_btd_B1_e12	GGGTGAAGCATTTTGCTGCTTCGCTgaagagtcttcctttacgta
Ccap_btd_B1_o13	gaggagggcagcaaacggaaAAACAGTAGCTGGGTCAGGCGATTT
Ccap_btd_B1_e13	ACATAGGCAGCGAGCGTCGGGCCGCgaagagtcttcctttacgta
Ccap_btd_B1_o14	gaggagggcagcaaacggaaGCGGATGTGCCTGGTTGTTGCTCAT
Ccap_btd_B1_e14	ATAGGTGAAGCGGACGTTACGTAGGgaagagtcttcctttacgta
Ccap_btd_B1_o15	gaggagggcagcaaacggaaCTGTTAGTTACAGGACTCGAAAGCA
Ccap_btd_B1_e15	GTTGTTGAGGTAGTTTCATTGTTGGgaagagtcttcctttacgta
Ccap_btd_B1_o16	gaggagggcagcaaacggaaGCCAGGTGAGCCCATGATGAGACCA
Ccap_btd_B1_e16	TACTGGTGAGGGTGAGCTATTGGAGgaagagtcttcctttacgta
Ccap_btd_B1_o17	gaggagggcagcaaacggaaGTTGGTATGCGGCTGCAGTAGCCCA
Ccap_btd_B1_e17	GCACTCTTCAAGCCGTGGCGTGTGAgaagagtcttcctttacgta
Ccap_btd_B1_o18	gaggagggcagcaaacggaaCGAACAAACAGGACACACAATAATG
Ccap_btd_B1_e18	GCCCACTCAGCTCAGCTCTCTTAACgaagagtcttcctttacgta
Ccap_btd_B1_o19	gaggagggcagcaaacggaaATTAAGGGGGGATGAAAATCAGTGG
Ccap_btd_B1_e19	CAGCAAGTTCTTTAGTGTGAACGTAgaagagtcttcctttacgta
Ccap_btd_B1_o20	gaggagggcagcaaacggaaATTTATGAGCAACACCAAGGCGCCA
Ccap_btd_B1_e20	GAACGCCTAATTTGCTAAAACCATCgaagagtcttcctttacgta
