Ccap_btd_B4_o01	cctcaacctacctccaacaaGTCAATAGTTCAAGATGTTGTGCGA
Ccap_btd_B4_e01	TTTGAGTGATGAACTCAGTGTCGAAtctcaccatattcgcttcat
Ccap_btd_B4_o02	cctcaacctacctccaacaaGACTGAGTGTGTGTACGCGTTGTTT
Ccap_btd_B4_e02	GTACGAAGAGGTTTTGCTTCAACAAtctcaccatattcgcttcat
Ccap_btd_B4_o03	cctcaacctacctccaacaaTACCAGCTAAGCACTGTATTTCATG
Ccap_btd_B4_e03	ACAGAGTGTTTGTCTGTTTGTTTGCtctcaccatattcgcttcat
Ccap_btd_B4_o04	cctcaacctacctccaacaaCACTGCCCAAAATGTACACAAATTC
Ccap_btd_B4_e04	GCTTTGCTCGTTGGTTATAAAACTGtctcaccatattcgcttcat
Ccap_btd_B4_o05	cctcaacctacctccaacaaTTGCACTAGAACTGCCGTTGGGAAC
Ccap_btd_B4_e05	GGGTGCAGTATATAATTAAGCGTTCtctcaccatattcgcttcat
Ccap_btd_B4_o06	cctcaacctacctccaacaaGCAGCTTCTGCTAACACTTTTGATA
Ccap_btd_B4_e06	TCGACTTGTCCAAAATGATGGATGGtctcaccatattcgcttcat
Ccap_btd_B4_o07	cctcaacctacctccaacaaTATTAACTGGCGGCATACTTGCGGC
Ccap_btd_B4_e07	GCTGTGACTGGTGATATTGATTGTTtctcaccatattcgcttcat
Ccap_btd_B4_o08	cctcaacctacctccaacaaTGTGATGCTGTATTTGGGGATTTCT
Ccap_btd_B4_e08	TTCATTCCAAGTGCACCACCTGCTAtctcaccatattcgcttcat
Ccap_btd_B4_o09	cctcaacctacctccaacaaCGGCGATACTGATGATGATGTTGCC
Ccap_btd_B4_e09	GTGTATAGAGTTTGGCGAGCCGGAAtctcaccatattcgcttcat
Ccap_btd_B4_o10	cctcaacctacctccaacaaTATAGTATTCCGGCGCATATTGAGC
Ccap_btd_B4_e10	GCTCTTGTGAAAACCAGGCGCTGTTtctcaccatattcgcttcat
Ccap_btd_B4_o11	cctcaacctacctccaacaaATATGTTGTTTGCGACCACGTTCGT
Ccap_btd_B4_e11	AACCGTTCACAGCCAGGTATATGACtctcaccatattcgcttcat
Ccap_btd_B4_o12	cctcaacctacctccaacaaGGCTGCAAGTTCTTTCTTGGTTTTT
Ccap_btd_B4_e12	GGGTGAAGCATTTTGCTGCTTCGCTtctcaccatattcgcttcat
Ccap_btd_B4_o13	cctcaacctacctccaacaaAAACAGTAGCTGGGTCAGGCGATTT
Ccap_btd_B4_e13	ACATAGGCAGCGAGCGTCGGGCCGCtctcaccatattcgcttcat
Ccap_btd_B4_o14	cctcaacctacctccaacaaGCGGATGTGCCTGGTTGTTGCTCAT
Ccap_btd_B4_e14	ATAGGTGAAGCGGACGTTACGTAGGtctcaccatattcgcttcat
Ccap_btd_B4_o15	cctcaacctacctccaacaaCTGTTAGTTACAGGACTCGAAAGCA
Ccap_btd_B4_e15	GTTGTTGAGGTAGTTTCATTGTTGGtctcaccatattcgcttcat
Ccap_btd_B4_o16	cctcaacctacctccaacaaGCCAGGTGAGCCCATGATGAGACCA
Ccap_btd_B4_e16	TACTGGTGAGGGTGAGCTATTGGAGtctcaccatattcgcttcat
Ccap_btd_B4_o17	cctcaacctacctccaacaaGTTGGTATGCGGCTGCAGTAGCCCA
Ccap_btd_B4_e17	GCACTCTTCAAGCCGTGGCGTGTGAtctcaccatattcgcttcat
Ccap_btd_B4_o18	cctcaacctacctccaacaaCGAACAAACAGGACACACAATAATG
Ccap_btd_B4_e18	GCCCACTCAGCTCAGCTCTCTTAACtctcaccatattcgcttcat
Ccap_btd_B4_o19	cctcaacctacctccaacaaATTAAGGGGGGATGAAAATCAGTGG
Ccap_btd_B4_e19	CAGCAAGTTCTTTAGTGTGAACGTAtctcaccatattcgcttcat
Ccap_btd_B4_o20	cctcaacctacctccaacaaATTTATGAGCAACACCAAGGCGCCA
Ccap_btd_B4_e20	GAACGCCTAATTTGCTAAAACCATCtctcaccatattcgcttcat
