Ccap_btd_B2_o01	cctcgtaaatcctcatcaaaGTCAATAGTTCAAGATGTTGTGCGA
Ccap_btd_B2_e01	TTTGAGTGATGAACTCAGTGTCGAAatcatccagtaaaccgccaa
Ccap_btd_B2_o02	cctcgtaaatcctcatcaaaGACTGAGTGTGTGTACGCGTTGTTT
Ccap_btd_B2_e02	GTACGAAGAGGTTTTGCTTCAACAAatcatccagtaaaccgccaa
Ccap_btd_B2_o03	cctcgtaaatcctcatcaaaTACCAGCTAAGCACTGTATTTCATG
Ccap_btd_B2_e03	ACAGAGTGTTTGTCTGTTTGTTTGCatcatccagtaaaccgccaa
Ccap_btd_B2_o04	cctcgtaaatcctcatcaaaCACTGCCCAAAATGTACACAAATTC
Ccap_btd_B2_e04	GCTTTGCTCGTTGGTTATAAAACTGatcatccagtaaaccgccaa
Ccap_btd_B2_o05	cctcgtaaatcctcatcaaaTTGCACTAGAACTGCCGTTGGGAAC
Ccap_btd_B2_e05	GGGTGCAGTATATAATTAAGCGTTCatcatccagtaaaccgccaa
Ccap_btd_B2_o06	cctcgtaaatcctcatcaaaGCAGCTTCTGCTAACACTTTTGATA
Ccap_btd_B2_e06	TCGACTTGTCCAAAATGATGGATGGatcatccagtaaaccgccaa
Ccap_btd_B2_o07	cctcgtaaatcctcatcaaaTATTAACTGGCGGCATACTTGCGGC
Ccap_btd_B2_e07	GCTGTGACTGGTGATATTGATTGTTatcatccagtaaaccgccaa
Ccap_btd_B2_o08	cctcgtaaatcctcatcaaaTGTGATGCTGTATTTGGGGATTTCT
Ccap_btd_B2_e08	TTCATTCCAAGTGCACCACCTGCTAatcatccagtaaaccgccaa
Ccap_btd_B2_o09	cctcgtaaatcctcatcaaaCGGCGATACTGATGATGATGTTGCC
Ccap_btd_B2_e09	GTGTATAGAGTTTGGCGAGCCGGAAatcatccagtaaaccgccaa
Ccap_btd_B2_o10	cctcgtaaatcctcatcaaaTATAGTATTCCGGCGCATATTGAGC
Ccap_btd_B2_e10	GCTCTTGTGAAAACCAGGCGCTGTTatcatccagtaaaccgccaa
Ccap_btd_B2_o11	cctcgtaaatcctcatcaaaATATGTTGTTTGCGACCACGTTCGT
Ccap_btd_B2_e11	AACCGTTCACAGCCAGGTATATGACatcatccagtaaaccgccaa
Ccap_btd_B2_o12	cctcgtaaatcctcatcaaaGGCTGCAAGTTCTTTCTTGGTTTTT
Ccap_btd_B2_e12	GGGTGAAGCATTTTGCTGCTTCGCTatcatccagtaaaccgccaa
Ccap_btd_B2_o13	cctcgtaaatcctcatcaaaAAACAGTAGCTGGGTCAGGCGATTT
Ccap_btd_B2_e13	ACATAGGCAGCGAGCGTCGGGCCGCatcatccagtaaaccgccaa
Ccap_btd_B2_o14	cctcgtaaatcctcatcaaaGCGGATGTGCCTGGTTGTTGCTCAT
Ccap_btd_B2_e14	ATAGGTGAAGCGGACGTTACGTAGGatcatccagtaaaccgccaa
Ccap_btd_B2_o15	cctcgtaaatcctcatcaaaCTGTTAGTTACAGGACTCGAAAGCA
Ccap_btd_B2_e15	GTTGTTGAGGTAGTTTCATTGTTGGatcatccagtaaaccgccaa
Ccap_btd_B2_o16	cctcgtaaatcctcatcaaaGCCAGGTGAGCCCATGATGAGACCA
Ccap_btd_B2_e16	TACTGGTGAGGGTGAGCTATTGGAGatcatccagtaaaccgccaa
Ccap_btd_B2_o17	cctcgtaaatcctcatcaaaGTTGGTATGCGGCTGCAGTAGCCCA
Ccap_btd_B2_e17	GCACTCTTCAAGCCGTGGCGTGTGAatcatccagtaaaccgccaa
Ccap_btd_B2_o18	cctcgtaaatcctcatcaaaCGAACAAACAGGACACACAATAATG
Ccap_btd_B2_e18	GCCCACTCAGCTCAGCTCTCTTAACatcatccagtaaaccgccaa
Ccap_btd_B2_o19	cctcgtaaatcctcatcaaaATTAAGGGGGGATGAAAATCAGTGG
Ccap_btd_B2_e19	CAGCAAGTTCTTTAGTGTGAACGTAatcatccagtaaaccgccaa
Ccap_btd_B2_o20	cctcgtaaatcctcatcaaaATTTATGAGCAACACCAAGGCGCCA
Ccap_btd_B2_e20	GAACGCCTAATTTGCTAAAACCATCatcatccagtaaaccgccaa
