Ccap_btd_B3_o01	gtccctgcctctatatctttGTCAATAGTTCAAGATGTTGTGCGA
Ccap_btd_B3_e01	TTTGAGTGATGAACTCAGTGTCGAAccactcaactttaacccgtt
Ccap_btd_B3_o02	gtccctgcctctatatctttGACTGAGTGTGTGTACGCGTTGTTT
Ccap_btd_B3_e02	GTACGAAGAGGTTTTGCTTCAACAAccactcaactttaacccgtt
Ccap_btd_B3_o03	gtccctgcctctatatctttTACCAGCTAAGCACTGTATTTCATG
Ccap_btd_B3_e03	ACAGAGTGTTTGTCTGTTTGTTTGCccactcaactttaacccgtt
Ccap_btd_B3_o04	gtccctgcctctatatctttCACTGCCCAAAATGTACACAAATTC
Ccap_btd_B3_e04	GCTTTGCTCGTTGGTTATAAAACTGccactcaactttaacccgtt
Ccap_btd_B3_o05	gtccctgcctctatatctttTTGCACTAGAACTGCCGTTGGGAAC
Ccap_btd_B3_e05	GGGTGCAGTATATAATTAAGCGTTCccactcaactttaacccgtt
Ccap_btd_B3_o06	gtccctgcctctatatctttGCAGCTTCTGCTAACACTTTTGATA
Ccap_btd_B3_e06	TCGACTTGTCCAAAATGATGGATGGccactcaactttaacccgtt
Ccap_btd_B3_o07	gtccctgcctctatatctttTATTAACTGGCGGCATACTTGCGGC
Ccap_btd_B3_e07	GCTGTGACTGGTGATATTGATTGTTccactcaactttaacccgtt
Ccap_btd_B3_o08	gtccctgcctctatatctttTGTGATGCTGTATTTGGGGATTTCT
Ccap_btd_B3_e08	TTCATTCCAAGTGCACCACCTGCTAccactcaactttaacccgtt
Ccap_btd_B3_o09	gtccctgcctctatatctttCGGCGATACTGATGATGATGTTGCC
Ccap_btd_B3_e09	GTGTATAGAGTTTGGCGAGCCGGAAccactcaactttaacccgtt
Ccap_btd_B3_o10	gtccctgcctctatatctttTATAGTATTCCGGCGCATATTGAGC
Ccap_btd_B3_e10	GCTCTTGTGAAAACCAGGCGCTGTTccactcaactttaacccgtt
Ccap_btd_B3_o11	gtccctgcctctatatctttATATGTTGTTTGCGACCACGTTCGT
Ccap_btd_B3_e11	AACCGTTCACAGCCAGGTATATGACccactcaactttaacccgtt
Ccap_btd_B3_o12	gtccctgcctctatatctttGGCTGCAAGTTCTTTCTTGGTTTTT
Ccap_btd_B3_e12	GGGTGAAGCATTTTGCTGCTTCGCTccactcaactttaacccgtt
Ccap_btd_B3_o13	gtccctgcctctatatctttAAACAGTAGCTGGGTCAGGCGATTT
Ccap_btd_B3_e13	ACATAGGCAGCGAGCGTCGGGCCGCccactcaactttaacccgtt
Ccap_btd_B3_o14	gtccctgcctctatatctttGCGGATGTGCCTGGTTGTTGCTCAT
Ccap_btd_B3_e14	ATAGGTGAAGCGGACGTTACGTAGGccactcaactttaacccgtt
Ccap_btd_B3_o15	gtccctgcctctatatctttCTGTTAGTTACAGGACTCGAAAGCA
Ccap_btd_B3_e15	GTTGTTGAGGTAGTTTCATTGTTGGccactcaactttaacccgtt
Ccap_btd_B3_o16	gtccctgcctctatatctttGCCAGGTGAGCCCATGATGAGACCA
Ccap_btd_B3_e16	TACTGGTGAGGGTGAGCTATTGGAGccactcaactttaacccgtt
Ccap_btd_B3_o17	gtccctgcctctatatctttGTTGGTATGCGGCTGCAGTAGCCCA
Ccap_btd_B3_e17	GCACTCTTCAAGCCGTGGCGTGTGAccactcaactttaacccgtt
Ccap_btd_B3_o18	gtccctgcctctatatctttCGAACAAACAGGACACACAATAATG
Ccap_btd_B3_e18	GCCCACTCAGCTCAGCTCTCTTAACccactcaactttaacccgtt
Ccap_btd_B3_o19	gtccctgcctctatatctttATTAAGGGGGGATGAAAATCAGTGG
Ccap_btd_B3_e19	CAGCAAGTTCTTTAGTGTGAACGTAccactcaactttaacccgtt
Ccap_btd_B3_o20	gtccctgcctctatatctttATTTATGAGCAACACCAAGGCGCCA
Ccap_btd_B3_e20	GAACGCCTAATTTGCTAAAACCATCccactcaactttaacccgtt
