Aste_eve_B3_o01	gtccctgcctctatatctttCGAACAAACACGCACATTGGCTGGG
Aste_eve_B3_e01	CCGTGAAAGTGTGATAATTTCCTACccactcaactttaacccgtt
Aste_eve_B3_o02	gtccctgcctctatatctttCGCTCCTAATTCATAAAGCACAAAC
Aste_eve_B3_e02	CGACGCTAAACGGTTGGTATCGGCGccactcaactttaacccgtt
Aste_eve_B3_o03	gtccctgcctctatatctttTCTGATTTTGCAGAAGTTGCTCAAC
Aste_eve_B3_e03	CACTTCAATATCCGTTCGTCACAATccactcaactttaacccgtt
Aste_eve_B3_o04	gtccctgcctctatatctttCGCGATGCTGCAGTGCATCCATGCC
Aste_eve_B3_e04	GGTCGACGGCTAATCCTACGCTTGAccactcaactttaacccgtt
Aste_eve_B3_o05	gtccctgcctctatatctttTAGTGGAGATAATGGAGGCGACGCC
Aste_eve_B3_e05	CGAGGAAGGTGGACTGTTGCAGTCGccactcaactttaacccgtt
Aste_eve_B3_o06	gtccctgcctctatatctttCGCCGGACAGATGGGTCCAGGGGCG
Aste_eve_B3_e06	TGGTCGCGGGTAAAGGCGGTTCGGTccactcaactttaacccgtt
Aste_eve_B3_o07	gtccctgcctctatatctttGTCGCGAGACGTAGTTTTCCTTGTA
Aste_eve_B3_e07	GCTGTGCGGCCAGCTCGCAGCGACGccactcaactttaacccgtt
Aste_eve_B3_o08	gtccctgcctctatatctttCATGCGGCGATTCTGAAACCAAACC
Aste_eve_B3_e08	CACCGCTATCCGTTGCCGTTTGTCCccactcaactttaacccgtt
Aste_eve_B3_o09	gtccctgcctctatatctttATCGAGGCGGCAAACGCCGGATCCG
Aste_eve_B3_e09	CCGACCGAGTTGGCAGCTGCCTGCAccactcaactttaacccgtt
Aste_eve_B3_o10	gtccctgcctctatatctttTAACTGGCATCTGGGTGAGCATGGG
Aste_eve_B3_e10	TCGCACCCGGCACTACCGGCGGCGGccactcaactttaacccgtt
Aste_eve_B3_o11	gtccctgcctctatatctttGCGGGGGTAGCCGTAAGCGGTGAAG
Aste_eve_B3_e11	GCGCTGCGGGAGCGGATACGGTGTGccactcaactttaacccgtt
Aste_eve_B3_o12	gtccctgcctctatatctttGGAGCCGTCGGTCCGGTGACGGGTG
Aste_eve_B3_e12	ATGGAGTTCGCCGCTGGATACACTCccactcaactttaacccgtt
Aste_eve_B3_o13	gtccctgcctctatatctttGCATGCTGAGTGGTGCGTACTGCGA
Aste_eve_B3_e13	TGTCCTGCGGTGGTGTTTGAGCCTTccactcaactttaacccgtt
Aste_eve_B3_o14	gtccctgcctctatatctttAGGGCTTCGGCCTTGGTGGTGAAGA
Aste_eve_B3_e14	CGAGAGTGCCGAATGGGGCGATGCAccactcaactttaacccgtt
Aste_eve_B3_o15	gtccctgcctctatatctttTTTGAGGTCGATGCGGAAGTGTCAA
Aste_eve_B3_e15	ACCGGACTGACGCTGGCGTTGCTCGccactcaactttaacccgtt
Aste_eve_B3_o16	gtccctgcctctatatctttCGGCGGCGGCCGCTAGCAACAGTCC
Aste_eve_B3_e16	GGCTAACTGACTGGTTGACGACGGCccactcaactttaacccgtt
Aste_eve_B3_o17	gtccctgcctctatatctttGCTTGAACAGTTTCGGTTTTTCCGG
Aste_eve_B3_e17	GATTTGATTACGCTTCGCACTTGTAccactcaactttaacccgtt
Aste_eve_B3_o18	gtccctgcctctatatctttCCGTGCGTTACAACACGTCAACCCG
Aste_eve_B3_e18	GCTATGCGTTTGATACAAACGCGAAccactcaactttaacccgtt
Aste_eve_B3_o19	gtccctgcctctatatctttGAGTTCTTACAGGGTACATGGTAAA
Aste_eve_B3_e19	ACGTTGCCTTTTACATCCGTTTGTCccactcaactttaacccgtt
Aste_eve_B3_o20	gtccctgcctctatatctttCGACCTGGCAAGTTCGATTAATTTT
Aste_eve_B3_e20	GGTTGGTTTTACTCTTTCGTAGTAGccactcaactttaacccgtt
