Aste_eve_B4_o01	cctcaacctacctccaacaaCGAACAAACACGCACATTGGCTGGG
Aste_eve_B4_e01	CCGTGAAAGTGTGATAATTTCCTACtctcaccatattcgcttcat
Aste_eve_B4_o02	cctcaacctacctccaacaaCGCTCCTAATTCATAAAGCACAAAC
Aste_eve_B4_e02	CGACGCTAAACGGTTGGTATCGGCGtctcaccatattcgcttcat
Aste_eve_B4_o03	cctcaacctacctccaacaaTCTGATTTTGCAGAAGTTGCTCAAC
Aste_eve_B4_e03	CACTTCAATATCCGTTCGTCACAATtctcaccatattcgcttcat
Aste_eve_B4_o04	cctcaacctacctccaacaaCGCGATGCTGCAGTGCATCCATGCC
Aste_eve_B4_e04	GGTCGACGGCTAATCCTACGCTTGAtctcaccatattcgcttcat
Aste_eve_B4_o05	cctcaacctacctccaacaaTAGTGGAGATAATGGAGGCGACGCC
Aste_eve_B4_e05	CGAGGAAGGTGGACTGTTGCAGTCGtctcaccatattcgcttcat
Aste_eve_B4_o06	cctcaacctacctccaacaaCGCCGGACAGATGGGTCCAGGGGCG
Aste_eve_B4_e06	TGGTCGCGGGTAAAGGCGGTTCGGTtctcaccatattcgcttcat
Aste_eve_B4_o07	cctcaacctacctccaacaaGTCGCGAGACGTAGTTTTCCTTGTA
Aste_eve_B4_e07	GCTGTGCGGCCAGCTCGCAGCGACGtctcaccatattcgcttcat
Aste_eve_B4_o08	cctcaacctacctccaacaaCATGCGGCGATTCTGAAACCAAACC
Aste_eve_B4_e08	CACCGCTATCCGTTGCCGTTTGTCCtctcaccatattcgcttcat
Aste_eve_B4_o09	cctcaacctacctccaacaaATCGAGGCGGCAAACGCCGGATCCG
Aste_eve_B4_e09	CCGACCGAGTTGGCAGCTGCCTGCAtctcaccatattcgcttcat
Aste_eve_B4_o10	cctcaacctacctccaacaaTAACTGGCATCTGGGTGAGCATGGG
Aste_eve_B4_e10	TCGCACCCGGCACTACCGGCGGCGGtctcaccatattcgcttcat
Aste_eve_B4_o11	cctcaacctacctccaacaaGCGGGGGTAGCCGTAAGCGGTGAAG
Aste_eve_B4_e11	GCGCTGCGGGAGCGGATACGGTGTGtctcaccatattcgcttcat
Aste_eve_B4_o12	cctcaacctacctccaacaaGGAGCCGTCGGTCCGGTGACGGGTG
Aste_eve_B4_e12	ATGGAGTTCGCCGCTGGATACACTCtctcaccatattcgcttcat
Aste_eve_B4_o13	cctcaacctacctccaacaaGCATGCTGAGTGGTGCGTACTGCGA
Aste_eve_B4_e13	TGTCCTGCGGTGGTGTTTGAGCCTTtctcaccatattcgcttcat
Aste_eve_B4_o14	cctcaacctacctccaacaaAGGGCTTCGGCCTTGGTGGTGAAGA
Aste_eve_B4_e14	CGAGAGTGCCGAATGGGGCGATGCAtctcaccatattcgcttcat
Aste_eve_B4_o15	cctcaacctacctccaacaaTTTGAGGTCGATGCGGAAGTGTCAA
Aste_eve_B4_e15	ACCGGACTGACGCTGGCGTTGCTCGtctcaccatattcgcttcat
Aste_eve_B4_o16	cctcaacctacctccaacaaCGGCGGCGGCCGCTAGCAACAGTCC
Aste_eve_B4_e16	GGCTAACTGACTGGTTGACGACGGCtctcaccatattcgcttcat
Aste_eve_B4_o17	cctcaacctacctccaacaaGCTTGAACAGTTTCGGTTTTTCCGG
Aste_eve_B4_e17	GATTTGATTACGCTTCGCACTTGTAtctcaccatattcgcttcat
Aste_eve_B4_o18	cctcaacctacctccaacaaCCGTGCGTTACAACACGTCAACCCG
Aste_eve_B4_e18	GCTATGCGTTTGATACAAACGCGAAtctcaccatattcgcttcat
Aste_eve_B4_o19	cctcaacctacctccaacaaGAGTTCTTACAGGGTACATGGTAAA
Aste_eve_B4_e19	ACGTTGCCTTTTACATCCGTTTGTCtctcaccatattcgcttcat
Aste_eve_B4_o20	cctcaacctacctccaacaaCGACCTGGCAAGTTCGATTAATTTT
Aste_eve_B4_e20	GGTTGGTTTTACTCTTTCGTAGTAGtctcaccatattcgcttcat
