Aste_eve_B2_o01	cctcgtaaatcctcatcaaaCGAACAAACACGCACATTGGCTGGG
Aste_eve_B2_e01	CCGTGAAAGTGTGATAATTTCCTACatcatccagtaaaccgccaa
Aste_eve_B2_o02	cctcgtaaatcctcatcaaaCGCTCCTAATTCATAAAGCACAAAC
Aste_eve_B2_e02	CGACGCTAAACGGTTGGTATCGGCGatcatccagtaaaccgccaa
Aste_eve_B2_o03	cctcgtaaatcctcatcaaaTCTGATTTTGCAGAAGTTGCTCAAC
Aste_eve_B2_e03	CACTTCAATATCCGTTCGTCACAATatcatccagtaaaccgccaa
Aste_eve_B2_o04	cctcgtaaatcctcatcaaaCGCGATGCTGCAGTGCATCCATGCC
Aste_eve_B2_e04	GGTCGACGGCTAATCCTACGCTTGAatcatccagtaaaccgccaa
Aste_eve_B2_o05	cctcgtaaatcctcatcaaaTAGTGGAGATAATGGAGGCGACGCC
Aste_eve_B2_e05	CGAGGAAGGTGGACTGTTGCAGTCGatcatccagtaaaccgccaa
Aste_eve_B2_o06	cctcgtaaatcctcatcaaaCGCCGGACAGATGGGTCCAGGGGCG
Aste_eve_B2_e06	TGGTCGCGGGTAAAGGCGGTTCGGTatcatccagtaaaccgccaa
Aste_eve_B2_o07	cctcgtaaatcctcatcaaaGTCGCGAGACGTAGTTTTCCTTGTA
Aste_eve_B2_e07	GCTGTGCGGCCAGCTCGCAGCGACGatcatccagtaaaccgccaa
Aste_eve_B2_o08	cctcgtaaatcctcatcaaaCATGCGGCGATTCTGAAACCAAACC
Aste_eve_B2_e08	CACCGCTATCCGTTGCCGTTTGTCCatcatccagtaaaccgccaa
Aste_eve_B2_o09	cctcgtaaatcctcatcaaaATCGAGGCGGCAAACGCCGGATCCG
Aste_eve_B2_e09	CCGACCGAGTTGGCAGCTGCCTGCAatcatccagtaaaccgccaa
Aste_eve_B2_o10	cctcgtaaatcctcatcaaaTAACTGGCATCTGGGTGAGCATGGG
Aste_eve_B2_e10	TCGCACCCGGCACTACCGGCGGCGGatcatccagtaaaccgccaa
Aste_eve_B2_o11	cctcgtaaatcctcatcaaaGCGGGGGTAGCCGTAAGCGGTGAAG
Aste_eve_B2_e11	GCGCTGCGGGAGCGGATACGGTGTGatcatccagtaaaccgccaa
Aste_eve_B2_o12	cctcgtaaatcctcatcaaaGGAGCCGTCGGTCCGGTGACGGGTG
Aste_eve_B2_e12	ATGGAGTTCGCCGCTGGATACACTCatcatccagtaaaccgccaa
Aste_eve_B2_o13	cctcgtaaatcctcatcaaaGCATGCTGAGTGGTGCGTACTGCGA
Aste_eve_B2_e13	TGTCCTGCGGTGGTGTTTGAGCCTTatcatccagtaaaccgccaa
Aste_eve_B2_o14	cctcgtaaatcctcatcaaaAGGGCTTCGGCCTTGGTGGTGAAGA
Aste_eve_B2_e14	CGAGAGTGCCGAATGGGGCGATGCAatcatccagtaaaccgccaa
Aste_eve_B2_o15	cctcgtaaatcctcatcaaaTTTGAGGTCGATGCGGAAGTGTCAA
Aste_eve_B2_e15	ACCGGACTGACGCTGGCGTTGCTCGatcatccagtaaaccgccaa
Aste_eve_B2_o16	cctcgtaaatcctcatcaaaCGGCGGCGGCCGCTAGCAACAGTCC
Aste_eve_B2_e16	GGCTAACTGACTGGTTGACGACGGCatcatccagtaaaccgccaa
Aste_eve_B2_o17	cctcgtaaatcctcatcaaaGCTTGAACAGTTTCGGTTTTTCCGG
Aste_eve_B2_e17	GATTTGATTACGCTTCGCACTTGTAatcatccagtaaaccgccaa
Aste_eve_B2_o18	cctcgtaaatcctcatcaaaCCGTGCGTTACAACACGTCAACCCG
Aste_eve_B2_e18	GCTATGCGTTTGATACAAACGCGAAatcatccagtaaaccgccaa
Aste_eve_B2_o19	cctcgtaaatcctcatcaaaGAGTTCTTACAGGGTACATGGTAAA
Aste_eve_B2_e19	ACGTTGCCTTTTACATCCGTTTGTCatcatccagtaaaccgccaa
Aste_eve_B2_o20	cctcgtaaatcctcatcaaaCGACCTGGCAAGTTCGATTAATTTT
Aste_eve_B2_e20	GGTTGGTTTTACTCTTTCGTAGTAGatcatccagtaaaccgccaa
