Aste_eve_B5_o01	ctcactcccaatctctataaCGAACAAACACGCACATTGGCTGGG
Aste_eve_B5_e01	CCGTGAAAGTGTGATAATTTCCTACctaccctacaaatccaataa
Aste_eve_B5_o02	ctcactcccaatctctataaCGCTCCTAATTCATAAAGCACAAAC
Aste_eve_B5_e02	CGACGCTAAACGGTTGGTATCGGCGctaccctacaaatccaataa
Aste_eve_B5_o03	ctcactcccaatctctataaTCTGATTTTGCAGAAGTTGCTCAAC
Aste_eve_B5_e03	CACTTCAATATCCGTTCGTCACAATctaccctacaaatccaataa
Aste_eve_B5_o04	ctcactcccaatctctataaCGCGATGCTGCAGTGCATCCATGCC
Aste_eve_B5_e04	GGTCGACGGCTAATCCTACGCTTGActaccctacaaatccaataa
Aste_eve_B5_o05	ctcactcccaatctctataaTAGTGGAGATAATGGAGGCGACGCC
Aste_eve_B5_e05	CGAGGAAGGTGGACTGTTGCAGTCGctaccctacaaatccaataa
Aste_eve_B5_o06	ctcactcccaatctctataaCGCCGGACAGATGGGTCCAGGGGCG
Aste_eve_B5_e06	TGGTCGCGGGTAAAGGCGGTTCGGTctaccctacaaatccaataa
Aste_eve_B5_o07	ctcactcccaatctctataaGTCGCGAGACGTAGTTTTCCTTGTA
Aste_eve_B5_e07	GCTGTGCGGCCAGCTCGCAGCGACGctaccctacaaatccaataa
Aste_eve_B5_o08	ctcactcccaatctctataaCATGCGGCGATTCTGAAACCAAACC
Aste_eve_B5_e08	CACCGCTATCCGTTGCCGTTTGTCCctaccctacaaatccaataa
Aste_eve_B5_o09	ctcactcccaatctctataaATCGAGGCGGCAAACGCCGGATCCG
Aste_eve_B5_e09	CCGACCGAGTTGGCAGCTGCCTGCActaccctacaaatccaataa
Aste_eve_B5_o10	ctcactcccaatctctataaTAACTGGCATCTGGGTGAGCATGGG
Aste_eve_B5_e10	TCGCACCCGGCACTACCGGCGGCGGctaccctacaaatccaataa
Aste_eve_B5_o11	ctcactcccaatctctataaGCGGGGGTAGCCGTAAGCGGTGAAG
Aste_eve_B5_e11	GCGCTGCGGGAGCGGATACGGTGTGctaccctacaaatccaataa
Aste_eve_B5_o12	ctcactcccaatctctataaGGAGCCGTCGGTCCGGTGACGGGTG
Aste_eve_B5_e12	ATGGAGTTCGCCGCTGGATACACTCctaccctacaaatccaataa
Aste_eve_B5_o13	ctcactcccaatctctataaGCATGCTGAGTGGTGCGTACTGCGA
Aste_eve_B5_e13	TGTCCTGCGGTGGTGTTTGAGCCTTctaccctacaaatccaataa
Aste_eve_B5_o14	ctcactcccaatctctataaAGGGCTTCGGCCTTGGTGGTGAAGA
Aste_eve_B5_e14	CGAGAGTGCCGAATGGGGCGATGCActaccctacaaatccaataa
Aste_eve_B5_o15	ctcactcccaatctctataaTTTGAGGTCGATGCGGAAGTGTCAA
Aste_eve_B5_e15	ACCGGACTGACGCTGGCGTTGCTCGctaccctacaaatccaataa
Aste_eve_B5_o16	ctcactcccaatctctataaCGGCGGCGGCCGCTAGCAACAGTCC
Aste_eve_B5_e16	GGCTAACTGACTGGTTGACGACGGCctaccctacaaatccaataa
Aste_eve_B5_o17	ctcactcccaatctctataaGCTTGAACAGTTTCGGTTTTTCCGG
Aste_eve_B5_e17	GATTTGATTACGCTTCGCACTTGTActaccctacaaatccaataa
Aste_eve_B5_o18	ctcactcccaatctctataaCCGTGCGTTACAACACGTCAACCCG
Aste_eve_B5_e18	GCTATGCGTTTGATACAAACGCGAActaccctacaaatccaataa
Aste_eve_B5_o19	ctcactcccaatctctataaGAGTTCTTACAGGGTACATGGTAAA
Aste_eve_B5_e19	ACGTTGCCTTTTACATCCGTTTGTCctaccctacaaatccaataa
Aste_eve_B5_o20	ctcactcccaatctctataaCGACCTGGCAAGTTCGATTAATTTT
Aste_eve_B5_e20	GGTTGGTTTTACTCTTTCGTAGTAGctaccctacaaatccaataa
