Aste_eve_B1_o01	gaggagggcagcaaacggaaCGAACAAACACGCACATTGGCTGGG
Aste_eve_B1_e01	CCGTGAAAGTGTGATAATTTCCTACgaagagtcttcctttacgta
Aste_eve_B1_o02	gaggagggcagcaaacggaaCGCTCCTAATTCATAAAGCACAAAC
Aste_eve_B1_e02	CGACGCTAAACGGTTGGTATCGGCGgaagagtcttcctttacgta
Aste_eve_B1_o03	gaggagggcagcaaacggaaTCTGATTTTGCAGAAGTTGCTCAAC
Aste_eve_B1_e03	CACTTCAATATCCGTTCGTCACAATgaagagtcttcctttacgta
Aste_eve_B1_o04	gaggagggcagcaaacggaaCGCGATGCTGCAGTGCATCCATGCC
Aste_eve_B1_e04	GGTCGACGGCTAATCCTACGCTTGAgaagagtcttcctttacgta
Aste_eve_B1_o05	gaggagggcagcaaacggaaTAGTGGAGATAATGGAGGCGACGCC
Aste_eve_B1_e05	CGAGGAAGGTGGACTGTTGCAGTCGgaagagtcttcctttacgta
Aste_eve_B1_o06	gaggagggcagcaaacggaaCGCCGGACAGATGGGTCCAGGGGCG
Aste_eve_B1_e06	TGGTCGCGGGTAAAGGCGGTTCGGTgaagagtcttcctttacgta
Aste_eve_B1_o07	gaggagggcagcaaacggaaGTCGCGAGACGTAGTTTTCCTTGTA
Aste_eve_B1_e07	GCTGTGCGGCCAGCTCGCAGCGACGgaagagtcttcctttacgta
Aste_eve_B1_o08	gaggagggcagcaaacggaaCATGCGGCGATTCTGAAACCAAACC
Aste_eve_B1_e08	CACCGCTATCCGTTGCCGTTTGTCCgaagagtcttcctttacgta
Aste_eve_B1_o09	gaggagggcagcaaacggaaATCGAGGCGGCAAACGCCGGATCCG
Aste_eve_B1_e09	CCGACCGAGTTGGCAGCTGCCTGCAgaagagtcttcctttacgta
Aste_eve_B1_o10	gaggagggcagcaaacggaaTAACTGGCATCTGGGTGAGCATGGG
Aste_eve_B1_e10	TCGCACCCGGCACTACCGGCGGCGGgaagagtcttcctttacgta
Aste_eve_B1_o11	gaggagggcagcaaacggaaGCGGGGGTAGCCGTAAGCGGTGAAG
Aste_eve_B1_e11	GCGCTGCGGGAGCGGATACGGTGTGgaagagtcttcctttacgta
Aste_eve_B1_o12	gaggagggcagcaaacggaaGGAGCCGTCGGTCCGGTGACGGGTG
Aste_eve_B1_e12	ATGGAGTTCGCCGCTGGATACACTCgaagagtcttcctttacgta
Aste_eve_B1_o13	gaggagggcagcaaacggaaGCATGCTGAGTGGTGCGTACTGCGA
Aste_eve_B1_e13	TGTCCTGCGGTGGTGTTTGAGCCTTgaagagtcttcctttacgta
Aste_eve_B1_o14	gaggagggcagcaaacggaaAGGGCTTCGGCCTTGGTGGTGAAGA
Aste_eve_B1_e14	CGAGAGTGCCGAATGGGGCGATGCAgaagagtcttcctttacgta
Aste_eve_B1_o15	gaggagggcagcaaacggaaTTTGAGGTCGATGCGGAAGTGTCAA
Aste_eve_B1_e15	ACCGGACTGACGCTGGCGTTGCTCGgaagagtcttcctttacgta
Aste_eve_B1_o16	gaggagggcagcaaacggaaCGGCGGCGGCCGCTAGCAACAGTCC
Aste_eve_B1_e16	GGCTAACTGACTGGTTGACGACGGCgaagagtcttcctttacgta
Aste_eve_B1_o17	gaggagggcagcaaacggaaGCTTGAACAGTTTCGGTTTTTCCGG
Aste_eve_B1_e17	GATTTGATTACGCTTCGCACTTGTAgaagagtcttcctttacgta
Aste_eve_B1_o18	gaggagggcagcaaacggaaCCGTGCGTTACAACACGTCAACCCG
Aste_eve_B1_e18	GCTATGCGTTTGATACAAACGCGAAgaagagtcttcctttacgta
Aste_eve_B1_o19	gaggagggcagcaaacggaaGAGTTCTTACAGGGTACATGGTAAA
Aste_eve_B1_e19	ACGTTGCCTTTTACATCCGTTTGTCgaagagtcttcctttacgta
Aste_eve_B1_o20	gaggagggcagcaaacggaaCGACCTGGCAAGTTCGATTAATTTT
Aste_eve_B1_e20	GGTTGGTTTTACTCTTTCGTAGTAGgaagagtcttcctttacgta
