Aste_btd_B4_o01	cctcaacctacctccaacaaGTCATGAAACTAGGTGAAGCCATCA
Aste_btd_B4_e01	TTGTTCCACTGGTGATTGTGATACTtctcaccatattcgcttcat
Aste_btd_B4_o02	cctcaacctacctccaacaaAGACTACTAACCGACGGTGGCTGTG
Aste_btd_B4_e02	GCCGAACCTACGGACGCCACCGATCtctcaccatattcgcttcat
Aste_btd_B4_o03	cctcaacctacctccaacaaGGACCACCGACGGTACTGAAGCTAC
Aste_btd_B4_e03	AGGGCGACGGCCGATCCGTGATTTCtctcaccatattcgcttcat
Aste_btd_B4_o04	cctcaacctacctccaacaaGCTGCCGCTGCGGCTGCCGTTACGT
Aste_btd_B4_e04	GATGCGGCCGCACTGGATGCGGCTGtctcaccatattcgcttcat
Aste_btd_B4_o05	cctcaacctacctccaacaaGCATACGACGGATAGTGCATGGCTT
Aste_btd_B4_e05	TTGTAGTAGCTGGCAGGACTGTACGtctcaccatattcgcttcat
Aste_btd_B4_o06	cctcaacctacctccaacaaTACGCGTCCGCACCGTGCCAGCCGG
Aste_btd_B4_e06	TGCGAGTACTCCTCCAGCTTGAGACtctcaccatattcgcttcat
Aste_btd_B4_o07	cctcaacctacctccaacaaACGACCGGTGGCAGCCCGGACAACT
Aste_btd_B4_e07	TGCCGCTTGCCCTTCTCATCCGGACtctcaccatattcgcttcat
Aste_btd_B4_o08	cctcaacctacctccaacaaCTTGCTACAGATCGTGCAGGTAAAC
Aste_btd_B4_e08	GGCGAGATGGTCGCTGCGCATAAACtctcaccatattcgcttcat
Aste_btd_B4_o09	cctcaacctacctccaacaaGCGTCGCATCTTCGCCTCCTCCAGC
Aste_btd_B4_e09	TTCGAGCGATTTTAGTTTCGTTTCCtctcaccatattcgcttcat
Aste_btd_B4_o10	cctcaacctacctccaacaaCAGCTTCGGGCGCTTGGCCGTGGTT
Aste_btd_B4_e10	ACGTGACTCACCCCCATCCCTGGCGtctcaccatattcgcttcat
Aste_btd_B4_o11	cctcaacctacctccaacaaGCTGTGATGCTGGTGCTGCTGGTGC
Aste_btd_B4_e11	GATGTCCTCCAGCATGGTGGACGTTtctcaccatattcgcttcat
Aste_btd_B4_o12	cctcaacctacctccaacaaACCGGTCGGCGGTGGCGTCAGGACA
Aste_btd_B4_e12	CGCTGCTGTTGCCGAGGTTGGCGAGtctcaccatattcgcttcat
Aste_btd_B4_o13	cctcaacctacctccaacaaGGAAGAAGGGACTCTGGAAGTATGA
Aste_btd_B4_e13	TGCCCGTGCCGACGTCGGCACTCGCtctcaccatattcgcttcat
Aste_btd_B4_o14	cctcaacctacctccaacaaCTCCATGATGGCTACTACCGTGACC
Aste_btd_B4_e14	TGCCACCACCTAGCCGCAGATTGTTtctcaccatattcgcttcat
Aste_btd_B4_o15	cctcaacctacctccaacaaCCTCCAACTTTACCAAACTGTTGCT
Aste_btd_B4_e15	CACCGAGACCATGCCCGTTGGCATAtctcaccatattcgcttcat
Aste_btd_B4_o16	cctcaacctacctccaacaaACGTGGTTGTTGAGGGTGTTGGTGT
Aste_btd_B4_e16	TGGTACAGCGGGGCACCGTGAGGTAtctcaccatattcgcttcat
Aste_btd_B4_o17	cctcaacctacctccaacaaGCGGATGGCATCCCAACACCACCAC
Aste_btd_B4_e17	TCGTAGGGTGAGATGCTTCCATAGGtctcaccatattcgcttcat
Aste_btd_B4_o18	cctcaacctacctccaacaaTGGGACGATGACGCCGACGTGGAGT
Aste_btd_B4_e18	ATCATCATGTTGTAGGTGGAGGCCAtctcaccatattcgcttcat
Aste_btd_B4_o19	cctcaacctacctccaacaaTGCTGTTGGTGCTGATGGTGATGAT
Aste_btd_B4_e19	TGTTGATTGAGAAGCTGTTGCTGCTtctcaccatattcgcttcat
Aste_btd_B4_o20	cctcaacctacctccaacaaTGCGCTGTAAGGTTGAGCTGAAGTT
Aste_btd_B4_e20	GTGGCGGTCGCACCGGCGTTCGCCTtctcaccatattcgcttcat
