Aste_btd_B1_o01	gaggagggcagcaaacggaaGTCATGAAACTAGGTGAAGCCATCA
Aste_btd_B1_e01	TTGTTCCACTGGTGATTGTGATACTgaagagtcttcctttacgta
Aste_btd_B1_o02	gaggagggcagcaaacggaaAGACTACTAACCGACGGTGGCTGTG
Aste_btd_B1_e02	GCCGAACCTACGGACGCCACCGATCgaagagtcttcctttacgta
Aste_btd_B1_o03	gaggagggcagcaaacggaaGGACCACCGACGGTACTGAAGCTAC
Aste_btd_B1_e03	AGGGCGACGGCCGATCCGTGATTTCgaagagtcttcctttacgta
Aste_btd_B1_o04	gaggagggcagcaaacggaaGCTGCCGCTGCGGCTGCCGTTACGT
Aste_btd_B1_e04	GATGCGGCCGCACTGGATGCGGCTGgaagagtcttcctttacgta
Aste_btd_B1_o05	gaggagggcagcaaacggaaGCATACGACGGATAGTGCATGGCTT
Aste_btd_B1_e05	TTGTAGTAGCTGGCAGGACTGTACGgaagagtcttcctttacgta
Aste_btd_B1_o06	gaggagggcagcaaacggaaTACGCGTCCGCACCGTGCCAGCCGG
Aste_btd_B1_e06	TGCGAGTACTCCTCCAGCTTGAGACgaagagtcttcctttacgta
Aste_btd_B1_o07	gaggagggcagcaaacggaaACGACCGGTGGCAGCCCGGACAACT
Aste_btd_B1_e07	TGCCGCTTGCCCTTCTCATCCGGACgaagagtcttcctttacgta
Aste_btd_B1_o08	gaggagggcagcaaacggaaCTTGCTACAGATCGTGCAGGTAAAC
Aste_btd_B1_e08	GGCGAGATGGTCGCTGCGCATAAACgaagagtcttcctttacgta
Aste_btd_B1_o09	gaggagggcagcaaacggaaGCGTCGCATCTTCGCCTCCTCCAGC
Aste_btd_B1_e09	TTCGAGCGATTTTAGTTTCGTTTCCgaagagtcttcctttacgta
Aste_btd_B1_o10	gaggagggcagcaaacggaaCAGCTTCGGGCGCTTGGCCGTGGTT
Aste_btd_B1_e10	ACGTGACTCACCCCCATCCCTGGCGgaagagtcttcctttacgta
Aste_btd_B1_o11	gaggagggcagcaaacggaaGCTGTGATGCTGGTGCTGCTGGTGC
Aste_btd_B1_e11	GATGTCCTCCAGCATGGTGGACGTTgaagagtcttcctttacgta
Aste_btd_B1_o12	gaggagggcagcaaacggaaACCGGTCGGCGGTGGCGTCAGGACA
Aste_btd_B1_e12	CGCTGCTGTTGCCGAGGTTGGCGAGgaagagtcttcctttacgta
Aste_btd_B1_o13	gaggagggcagcaaacggaaGGAAGAAGGGACTCTGGAAGTATGA
Aste_btd_B1_e13	TGCCCGTGCCGACGTCGGCACTCGCgaagagtcttcctttacgta
Aste_btd_B1_o14	gaggagggcagcaaacggaaCTCCATGATGGCTACTACCGTGACC
Aste_btd_B1_e14	TGCCACCACCTAGCCGCAGATTGTTgaagagtcttcctttacgta
Aste_btd_B1_o15	gaggagggcagcaaacggaaCCTCCAACTTTACCAAACTGTTGCT
Aste_btd_B1_e15	CACCGAGACCATGCCCGTTGGCATAgaagagtcttcctttacgta
Aste_btd_B1_o16	gaggagggcagcaaacggaaACGTGGTTGTTGAGGGTGTTGGTGT
Aste_btd_B1_e16	TGGTACAGCGGGGCACCGTGAGGTAgaagagtcttcctttacgta
Aste_btd_B1_o17	gaggagggcagcaaacggaaGCGGATGGCATCCCAACACCACCAC
Aste_btd_B1_e17	TCGTAGGGTGAGATGCTTCCATAGGgaagagtcttcctttacgta
Aste_btd_B1_o18	gaggagggcagcaaacggaaTGGGACGATGACGCCGACGTGGAGT
Aste_btd_B1_e18	ATCATCATGTTGTAGGTGGAGGCCAgaagagtcttcctttacgta
Aste_btd_B1_o19	gaggagggcagcaaacggaaTGCTGTTGGTGCTGATGGTGATGAT
Aste_btd_B1_e19	TGTTGATTGAGAAGCTGTTGCTGCTgaagagtcttcctttacgta
Aste_btd_B1_o20	gaggagggcagcaaacggaaTGCGCTGTAAGGTTGAGCTGAAGTT
Aste_btd_B1_e20	GTGGCGGTCGCACCGGCGTTCGCCTgaagagtcttcctttacgta
