Aste_btd_B3_o01	gtccctgcctctatatctttGTCATGAAACTAGGTGAAGCCATCA
Aste_btd_B3_e01	TTGTTCCACTGGTGATTGTGATACTccactcaactttaacccgtt
Aste_btd_B3_o02	gtccctgcctctatatctttAGACTACTAACCGACGGTGGCTGTG
Aste_btd_B3_e02	GCCGAACCTACGGACGCCACCGATCccactcaactttaacccgtt
Aste_btd_B3_o03	gtccctgcctctatatctttGGACCACCGACGGTACTGAAGCTAC
Aste_btd_B3_e03	AGGGCGACGGCCGATCCGTGATTTCccactcaactttaacccgtt
Aste_btd_B3_o04	gtccctgcctctatatctttGCTGCCGCTGCGGCTGCCGTTACGT
Aste_btd_B3_e04	GATGCGGCCGCACTGGATGCGGCTGccactcaactttaacccgtt
Aste_btd_B3_o05	gtccctgcctctatatctttGCATACGACGGATAGTGCATGGCTT
Aste_btd_B3_e05	TTGTAGTAGCTGGCAGGACTGTACGccactcaactttaacccgtt
Aste_btd_B3_o06	gtccctgcctctatatctttTACGCGTCCGCACCGTGCCAGCCGG
Aste_btd_B3_e06	TGCGAGTACTCCTCCAGCTTGAGACccactcaactttaacccgtt
Aste_btd_B3_o07	gtccctgcctctatatctttACGACCGGTGGCAGCCCGGACAACT
Aste_btd_B3_e07	TGCCGCTTGCCCTTCTCATCCGGACccactcaactttaacccgtt
Aste_btd_B3_o08	gtccctgcctctatatctttCTTGCTACAGATCGTGCAGGTAAAC
Aste_btd_B3_e08	GGCGAGATGGTCGCTGCGCATAAACccactcaactttaacccgtt
Aste_btd_B3_o09	gtccctgcctctatatctttGCGTCGCATCTTCGCCTCCTCCAGC
Aste_btd_B3_e09	TTCGAGCGATTTTAGTTTCGTTTCCccactcaactttaacccgtt
Aste_btd_B3_o10	gtccctgcctctatatctttCAGCTTCGGGCGCTTGGCCGTGGTT
Aste_btd_B3_e10	ACGTGACTCACCCCCATCCCTGGCGccactcaactttaacccgtt
Aste_btd_B3_o11	gtccctgcctctatatctttGCTGTGATGCTGGTGCTGCTGGTGC
Aste_btd_B3_e11	GATGTCCTCCAGCATGGTGGACGTTccactcaactttaacccgtt
Aste_btd_B3_o12	gtccctgcctctatatctttACCGGTCGGCGGTGGCGTCAGGACA
Aste_btd_B3_e12	CGCTGCTGTTGCCGAGGTTGGCGAGccactcaactttaacccgtt
Aste_btd_B3_o13	gtccctgcctctatatctttGGAAGAAGGGACTCTGGAAGTATGA
Aste_btd_B3_e13	TGCCCGTGCCGACGTCGGCACTCGCccactcaactttaacccgtt
Aste_btd_B3_o14	gtccctgcctctatatctttCTCCATGATGGCTACTACCGTGACC
Aste_btd_B3_e14	TGCCACCACCTAGCCGCAGATTGTTccactcaactttaacccgtt
Aste_btd_B3_o15	gtccctgcctctatatctttCCTCCAACTTTACCAAACTGTTGCT
Aste_btd_B3_e15	CACCGAGACCATGCCCGTTGGCATAccactcaactttaacccgtt
Aste_btd_B3_o16	gtccctgcctctatatctttACGTGGTTGTTGAGGGTGTTGGTGT
Aste_btd_B3_e16	TGGTACAGCGGGGCACCGTGAGGTAccactcaactttaacccgtt
Aste_btd_B3_o17	gtccctgcctctatatctttGCGGATGGCATCCCAACACCACCAC
Aste_btd_B3_e17	TCGTAGGGTGAGATGCTTCCATAGGccactcaactttaacccgtt
Aste_btd_B3_o18	gtccctgcctctatatctttTGGGACGATGACGCCGACGTGGAGT
Aste_btd_B3_e18	ATCATCATGTTGTAGGTGGAGGCCAccactcaactttaacccgtt
Aste_btd_B3_o19	gtccctgcctctatatctttTGCTGTTGGTGCTGATGGTGATGAT
Aste_btd_B3_e19	TGTTGATTGAGAAGCTGTTGCTGCTccactcaactttaacccgtt
Aste_btd_B3_o20	gtccctgcctctatatctttTGCGCTGTAAGGTTGAGCTGAAGTT
Aste_btd_B3_e20	GTGGCGGTCGCACCGGCGTTCGCCTccactcaactttaacccgtt
