Aste_btd_B2_o01	cctcgtaaatcctcatcaaaGTCATGAAACTAGGTGAAGCCATCA
Aste_btd_B2_e01	TTGTTCCACTGGTGATTGTGATACTatcatccagtaaaccgccaa
Aste_btd_B2_o02	cctcgtaaatcctcatcaaaAGACTACTAACCGACGGTGGCTGTG
Aste_btd_B2_e02	GCCGAACCTACGGACGCCACCGATCatcatccagtaaaccgccaa
Aste_btd_B2_o03	cctcgtaaatcctcatcaaaGGACCACCGACGGTACTGAAGCTAC
Aste_btd_B2_e03	AGGGCGACGGCCGATCCGTGATTTCatcatccagtaaaccgccaa
Aste_btd_B2_o04	cctcgtaaatcctcatcaaaGCTGCCGCTGCGGCTGCCGTTACGT
Aste_btd_B2_e04	GATGCGGCCGCACTGGATGCGGCTGatcatccagtaaaccgccaa
Aste_btd_B2_o05	cctcgtaaatcctcatcaaaGCATACGACGGATAGTGCATGGCTT
Aste_btd_B2_e05	TTGTAGTAGCTGGCAGGACTGTACGatcatccagtaaaccgccaa
Aste_btd_B2_o06	cctcgtaaatcctcatcaaaTACGCGTCCGCACCGTGCCAGCCGG
Aste_btd_B2_e06	TGCGAGTACTCCTCCAGCTTGAGACatcatccagtaaaccgccaa
Aste_btd_B2_o07	cctcgtaaatcctcatcaaaACGACCGGTGGCAGCCCGGACAACT
Aste_btd_B2_e07	TGCCGCTTGCCCTTCTCATCCGGACatcatccagtaaaccgccaa
Aste_btd_B2_o08	cctcgtaaatcctcatcaaaCTTGCTACAGATCGTGCAGGTAAAC
Aste_btd_B2_e08	GGCGAGATGGTCGCTGCGCATAAACatcatccagtaaaccgccaa
Aste_btd_B2_o09	cctcgtaaatcctcatcaaaGCGTCGCATCTTCGCCTCCTCCAGC
Aste_btd_B2_e09	TTCGAGCGATTTTAGTTTCGTTTCCatcatccagtaaaccgccaa
Aste_btd_B2_o10	cctcgtaaatcctcatcaaaCAGCTTCGGGCGCTTGGCCGTGGTT
Aste_btd_B2_e10	ACGTGACTCACCCCCATCCCTGGCGatcatccagtaaaccgccaa
Aste_btd_B2_o11	cctcgtaaatcctcatcaaaGCTGTGATGCTGGTGCTGCTGGTGC
Aste_btd_B2_e11	GATGTCCTCCAGCATGGTGGACGTTatcatccagtaaaccgccaa
Aste_btd_B2_o12	cctcgtaaatcctcatcaaaACCGGTCGGCGGTGGCGTCAGGACA
Aste_btd_B2_e12	CGCTGCTGTTGCCGAGGTTGGCGAGatcatccagtaaaccgccaa
Aste_btd_B2_o13	cctcgtaaatcctcatcaaaGGAAGAAGGGACTCTGGAAGTATGA
Aste_btd_B2_e13	TGCCCGTGCCGACGTCGGCACTCGCatcatccagtaaaccgccaa
Aste_btd_B2_o14	cctcgtaaatcctcatcaaaCTCCATGATGGCTACTACCGTGACC
Aste_btd_B2_e14	TGCCACCACCTAGCCGCAGATTGTTatcatccagtaaaccgccaa
Aste_btd_B2_o15	cctcgtaaatcctcatcaaaCCTCCAACTTTACCAAACTGTTGCT
Aste_btd_B2_e15	CACCGAGACCATGCCCGTTGGCATAatcatccagtaaaccgccaa
Aste_btd_B2_o16	cctcgtaaatcctcatcaaaACGTGGTTGTTGAGGGTGTTGGTGT
Aste_btd_B2_e16	TGGTACAGCGGGGCACCGTGAGGTAatcatccagtaaaccgccaa
Aste_btd_B2_o17	cctcgtaaatcctcatcaaaGCGGATGGCATCCCAACACCACCAC
Aste_btd_B2_e17	TCGTAGGGTGAGATGCTTCCATAGGatcatccagtaaaccgccaa
Aste_btd_B2_o18	cctcgtaaatcctcatcaaaTGGGACGATGACGCCGACGTGGAGT
Aste_btd_B2_e18	ATCATCATGTTGTAGGTGGAGGCCAatcatccagtaaaccgccaa
Aste_btd_B2_o19	cctcgtaaatcctcatcaaaTGCTGTTGGTGCTGATGGTGATGAT
Aste_btd_B2_e19	TGTTGATTGAGAAGCTGTTGCTGCTatcatccagtaaaccgccaa
Aste_btd_B2_o20	cctcgtaaatcctcatcaaaTGCGCTGTAAGGTTGAGCTGAAGTT
Aste_btd_B2_e20	GTGGCGGTCGCACCGGCGTTCGCCTatcatccagtaaaccgccaa
