Aste_btd_B5_o01	ctcactcccaatctctataaGTCATGAAACTAGGTGAAGCCATCA
Aste_btd_B5_e01	TTGTTCCACTGGTGATTGTGATACTctaccctacaaatccaataa
Aste_btd_B5_o02	ctcactcccaatctctataaAGACTACTAACCGACGGTGGCTGTG
Aste_btd_B5_e02	GCCGAACCTACGGACGCCACCGATCctaccctacaaatccaataa
Aste_btd_B5_o03	ctcactcccaatctctataaGGACCACCGACGGTACTGAAGCTAC
Aste_btd_B5_e03	AGGGCGACGGCCGATCCGTGATTTCctaccctacaaatccaataa
Aste_btd_B5_o04	ctcactcccaatctctataaGCTGCCGCTGCGGCTGCCGTTACGT
Aste_btd_B5_e04	GATGCGGCCGCACTGGATGCGGCTGctaccctacaaatccaataa
Aste_btd_B5_o05	ctcactcccaatctctataaGCATACGACGGATAGTGCATGGCTT
Aste_btd_B5_e05	TTGTAGTAGCTGGCAGGACTGTACGctaccctacaaatccaataa
Aste_btd_B5_o06	ctcactcccaatctctataaTACGCGTCCGCACCGTGCCAGCCGG
Aste_btd_B5_e06	TGCGAGTACTCCTCCAGCTTGAGACctaccctacaaatccaataa
Aste_btd_B5_o07	ctcactcccaatctctataaACGACCGGTGGCAGCCCGGACAACT
Aste_btd_B5_e07	TGCCGCTTGCCCTTCTCATCCGGACctaccctacaaatccaataa
Aste_btd_B5_o08	ctcactcccaatctctataaCTTGCTACAGATCGTGCAGGTAAAC
Aste_btd_B5_e08	GGCGAGATGGTCGCTGCGCATAAACctaccctacaaatccaataa
Aste_btd_B5_o09	ctcactcccaatctctataaGCGTCGCATCTTCGCCTCCTCCAGC
Aste_btd_B5_e09	TTCGAGCGATTTTAGTTTCGTTTCCctaccctacaaatccaataa
Aste_btd_B5_o10	ctcactcccaatctctataaCAGCTTCGGGCGCTTGGCCGTGGTT
Aste_btd_B5_e10	ACGTGACTCACCCCCATCCCTGGCGctaccctacaaatccaataa
Aste_btd_B5_o11	ctcactcccaatctctataaGCTGTGATGCTGGTGCTGCTGGTGC
Aste_btd_B5_e11	GATGTCCTCCAGCATGGTGGACGTTctaccctacaaatccaataa
Aste_btd_B5_o12	ctcactcccaatctctataaACCGGTCGGCGGTGGCGTCAGGACA
Aste_btd_B5_e12	CGCTGCTGTTGCCGAGGTTGGCGAGctaccctacaaatccaataa
Aste_btd_B5_o13	ctcactcccaatctctataaGGAAGAAGGGACTCTGGAAGTATGA
Aste_btd_B5_e13	TGCCCGTGCCGACGTCGGCACTCGCctaccctacaaatccaataa
Aste_btd_B5_o14	ctcactcccaatctctataaCTCCATGATGGCTACTACCGTGACC
Aste_btd_B5_e14	TGCCACCACCTAGCCGCAGATTGTTctaccctacaaatccaataa
Aste_btd_B5_o15	ctcactcccaatctctataaCCTCCAACTTTACCAAACTGTTGCT
Aste_btd_B5_e15	CACCGAGACCATGCCCGTTGGCATActaccctacaaatccaataa
Aste_btd_B5_o16	ctcactcccaatctctataaACGTGGTTGTTGAGGGTGTTGGTGT
Aste_btd_B5_e16	TGGTACAGCGGGGCACCGTGAGGTActaccctacaaatccaataa
Aste_btd_B5_o17	ctcactcccaatctctataaGCGGATGGCATCCCAACACCACCAC
Aste_btd_B5_e17	TCGTAGGGTGAGATGCTTCCATAGGctaccctacaaatccaataa
Aste_btd_B5_o18	ctcactcccaatctctataaTGGGACGATGACGCCGACGTGGAGT
Aste_btd_B5_e18	ATCATCATGTTGTAGGTGGAGGCCActaccctacaaatccaataa
Aste_btd_B5_o19	ctcactcccaatctctataaTGCTGTTGGTGCTGATGGTGATGAT
Aste_btd_B5_e19	TGTTGATTGAGAAGCTGTTGCTGCTctaccctacaaatccaataa
Aste_btd_B5_o20	ctcactcccaatctctataaTGCGCTGTAAGGTTGAGCTGAAGTT
Aste_btd_B5_e20	GTGGCGGTCGCACCGGCGTTCGCCTctaccctacaaatccaataa
