Ccap_eve_B1_o01	gaggagggcagcaaacggaaAACACCAAGTGGGTAGGAAAAGAAT
Ccap_eve_B1_e01	GCCATGCCTTTTAGTAAATTAGTGCgaagagtcttcctttacgta
Ccap_eve_B1_o02	gaggagggcagcaaacggaaCAACTCAAATCAGTCCCGTTTCCTT
Ccap_eve_B1_e02	CGATAAAACTGTCCGGCAAATTCATgaagagtcttcctttacgta
Ccap_eve_B1_o03	gaggagggcagcaaacggaaGTAGACTATGGCCTCATAATGTCTA
Ccap_eve_B1_e03	AAACGACATTTCTCATAAGCCAGTGgaagagtcttcctttacgta
Ccap_eve_B1_o04	gaggagggcagcaaacggaaGCGCAATGGGGCAATGGGAGCACAG
Ccap_eve_B1_e04	GCTTCCACCCAGCAAAATTAAGTTTgaagagtcttcctttacgta
Ccap_eve_B1_o05	gaggagggcagcaaacggaaTACTGCGTGGCTCTTTGAAAATCGA
Ccap_eve_B1_e05	CCTTCCGAACAATTTTGATGAGGAAgaagagtcttcctttacgta
Ccap_eve_B1_o06	gaggagggcagcaaacggaaATGTCGCCATGTGTGTCTGTATGGG
Ccap_eve_B1_e06	GCAATGGAAGAGTGTCTATATGCATgaagagtcttcctttacgta
Ccap_eve_B1_o07	gaggagggcagcaaacggaaCATGTAAGAAGAGGGCGTTTTTCAT
Ccap_eve_B1_e07	CTGAGGCTGAAGAGAGAGCACGTATgaagagtcttcctttacgta
Ccap_eve_B1_o08	gaggagggcagcaaacggaaCTTTGCCTGTTGAAAATTGTACGGT
Ccap_eve_B1_e08	CTCTTCTCCGTTTTCAAAATATCGCgaagagtcttcctttacgta
Ccap_eve_B1_o09	gaggagggcagcaaacggaaCCAAAGACGTGCATATTGTTAGCGC
Ccap_eve_B1_e09	GCGGCATACTGAACATCCATATTATgaagagtcttcctttacgta
Ccap_eve_B1_o10	gaggagggcagcaaacggaaGGCATTCATTTGGTGAGGGTGGCGG
Ccap_eve_B1_e10	TGTTCATTGTTGAGTCTGAACTCGAgaagagtcttcctttacgta
Ccap_eve_B1_o11	gaggagggcagcaaacggaaTCCTTTTCCAAGCGTGTCAATTGAT
Ccap_eve_B1_e11	CGAGAGACGTAGTTTTCTTTGAAGAgaagagtcttcctttacgta
Ccap_eve_B1_o12	gaggagggcagcaaacggaaGATGGCGTTTATCCTTCATACGACG
Ccap_eve_B1_e12	CGGCGTAAGGCCATGCCACAGCCATgaagagtcttcctttacgta
Ccap_eve_B1_o13	gaggagggcagcaaacggaaTGGGCCCGGTGCGGGATAAGGAGGA
Ccap_eve_B1_e13	CATGCCGGGCGTTGGTAACATAGGAgaagagtcttcctttacgta
Ccap_eve_B1_o14	gaggagggcagcaaacggaaGGCTGCTGCATTGGTGCTGGCGGTG
Ccap_eve_B1_e14	GGTGGCATACCATGATGATGATGATgaagagtcttcctttacgta
Ccap_eve_B1_o15	gaggagggcagcaaacggaaTGCCTGGTGGATAGTTTGTGGCACA
Ccap_eve_B1_e15	GTGGTGGCATCATGCCAATACCCATgaagagtcttcctttacgta
Ccap_eve_B1_o16	gaggagggcagcaaacggaaTGACAGTGTGGAGGAGTTCGGCGAT
Ccap_eve_B1_e16	GGTGTGATCCGAGCCGGTTGGACTCgaagagtcttcctttacgta
Ccap_eve_B1_o17	gaggagggcagcaaacggaaGGATTATGCTAATATATTCGGCGCT
Ccap_eve_B1_e17	TGGCGCTGGTGTTGTTGTGGCTCTCgaagagtcttcctttacgta
Ccap_eve_B1_o18	gaggagggcagcaaacggaaATTGGCAGGCAATGGTTCGCTGTTT
Ccap_eve_B1_e18	GGTTAGGTGATGGCTCATTTCTTGGgaagagtcttcctttacgta
Ccap_eve_B1_o19	gaggagggcagcaaacggaaGCGGGCGCTGGTCGCTTAACAGCCG
Ccap_eve_B1_e19	ACAACTGTCCGCTCCGCCGGTGAATgaagagtcttcctttacgta
Ccap_eve_B1_o20	gaggagggcagcaaacggaaGTCACTCGGCCAACAAATTATTGTT
Ccap_eve_B1_e20	TTTTTGAGTTGTTGGCCATCAGAACgaagagtcttcctttacgta
