Ccap_eve_B3_o01	gtccctgcctctatatctttAACACCAAGTGGGTAGGAAAAGAAT
Ccap_eve_B3_e01	GCCATGCCTTTTAGTAAATTAGTGCccactcaactttaacccgtt
Ccap_eve_B3_o02	gtccctgcctctatatctttCAACTCAAATCAGTCCCGTTTCCTT
Ccap_eve_B3_e02	CGATAAAACTGTCCGGCAAATTCATccactcaactttaacccgtt
Ccap_eve_B3_o03	gtccctgcctctatatctttGTAGACTATGGCCTCATAATGTCTA
Ccap_eve_B3_e03	AAACGACATTTCTCATAAGCCAGTGccactcaactttaacccgtt
Ccap_eve_B3_o04	gtccctgcctctatatctttGCGCAATGGGGCAATGGGAGCACAG
Ccap_eve_B3_e04	GCTTCCACCCAGCAAAATTAAGTTTccactcaactttaacccgtt
Ccap_eve_B3_o05	gtccctgcctctatatctttTACTGCGTGGCTCTTTGAAAATCGA
Ccap_eve_B3_e05	CCTTCCGAACAATTTTGATGAGGAAccactcaactttaacccgtt
Ccap_eve_B3_o06	gtccctgcctctatatctttATGTCGCCATGTGTGTCTGTATGGG
Ccap_eve_B3_e06	GCAATGGAAGAGTGTCTATATGCATccactcaactttaacccgtt
Ccap_eve_B3_o07	gtccctgcctctatatctttCATGTAAGAAGAGGGCGTTTTTCAT
Ccap_eve_B3_e07	CTGAGGCTGAAGAGAGAGCACGTATccactcaactttaacccgtt
Ccap_eve_B3_o08	gtccctgcctctatatctttCTTTGCCTGTTGAAAATTGTACGGT
Ccap_eve_B3_e08	CTCTTCTCCGTTTTCAAAATATCGCccactcaactttaacccgtt
Ccap_eve_B3_o09	gtccctgcctctatatctttCCAAAGACGTGCATATTGTTAGCGC
Ccap_eve_B3_e09	GCGGCATACTGAACATCCATATTATccactcaactttaacccgtt
Ccap_eve_B3_o10	gtccctgcctctatatctttGGCATTCATTTGGTGAGGGTGGCGG
Ccap_eve_B3_e10	TGTTCATTGTTGAGTCTGAACTCGAccactcaactttaacccgtt
Ccap_eve_B3_o11	gtccctgcctctatatctttTCCTTTTCCAAGCGTGTCAATTGAT
Ccap_eve_B3_e11	CGAGAGACGTAGTTTTCTTTGAAGAccactcaactttaacccgtt
Ccap_eve_B3_o12	gtccctgcctctatatctttGATGGCGTTTATCCTTCATACGACG
Ccap_eve_B3_e12	CGGCGTAAGGCCATGCCACAGCCATccactcaactttaacccgtt
Ccap_eve_B3_o13	gtccctgcctctatatctttTGGGCCCGGTGCGGGATAAGGAGGA
Ccap_eve_B3_e13	CATGCCGGGCGTTGGTAACATAGGAccactcaactttaacccgtt
Ccap_eve_B3_o14	gtccctgcctctatatctttGGCTGCTGCATTGGTGCTGGCGGTG
Ccap_eve_B3_e14	GGTGGCATACCATGATGATGATGATccactcaactttaacccgtt
Ccap_eve_B3_o15	gtccctgcctctatatctttTGCCTGGTGGATAGTTTGTGGCACA
Ccap_eve_B3_e15	GTGGTGGCATCATGCCAATACCCATccactcaactttaacccgtt
Ccap_eve_B3_o16	gtccctgcctctatatctttTGACAGTGTGGAGGAGTTCGGCGAT
Ccap_eve_B3_e16	GGTGTGATCCGAGCCGGTTGGACTCccactcaactttaacccgtt
Ccap_eve_B3_o17	gtccctgcctctatatctttGGATTATGCTAATATATTCGGCGCT
Ccap_eve_B3_e17	TGGCGCTGGTGTTGTTGTGGCTCTCccactcaactttaacccgtt
Ccap_eve_B3_o18	gtccctgcctctatatctttATTGGCAGGCAATGGTTCGCTGTTT
Ccap_eve_B3_e18	GGTTAGGTGATGGCTCATTTCTTGGccactcaactttaacccgtt
Ccap_eve_B3_o19	gtccctgcctctatatctttGCGGGCGCTGGTCGCTTAACAGCCG
Ccap_eve_B3_e19	ACAACTGTCCGCTCCGCCGGTGAATccactcaactttaacccgtt
Ccap_eve_B3_o20	gtccctgcctctatatctttGTCACTCGGCCAACAAATTATTGTT
Ccap_eve_B3_e20	TTTTTGAGTTGTTGGCCATCAGAACccactcaactttaacccgtt
