Ccap_eve_B2_o01	cctcgtaaatcctcatcaaaAACACCAAGTGGGTAGGAAAAGAAT
Ccap_eve_B2_e01	GCCATGCCTTTTAGTAAATTAGTGCatcatccagtaaaccgccaa
Ccap_eve_B2_o02	cctcgtaaatcctcatcaaaCAACTCAAATCAGTCCCGTTTCCTT
Ccap_eve_B2_e02	CGATAAAACTGTCCGGCAAATTCATatcatccagtaaaccgccaa
Ccap_eve_B2_o03	cctcgtaaatcctcatcaaaGTAGACTATGGCCTCATAATGTCTA
Ccap_eve_B2_e03	AAACGACATTTCTCATAAGCCAGTGatcatccagtaaaccgccaa
Ccap_eve_B2_o04	cctcgtaaatcctcatcaaaGCGCAATGGGGCAATGGGAGCACAG
Ccap_eve_B2_e04	GCTTCCACCCAGCAAAATTAAGTTTatcatccagtaaaccgccaa
Ccap_eve_B2_o05	cctcgtaaatcctcatcaaaTACTGCGTGGCTCTTTGAAAATCGA
Ccap_eve_B2_e05	CCTTCCGAACAATTTTGATGAGGAAatcatccagtaaaccgccaa
Ccap_eve_B2_o06	cctcgtaaatcctcatcaaaATGTCGCCATGTGTGTCTGTATGGG
Ccap_eve_B2_e06	GCAATGGAAGAGTGTCTATATGCATatcatccagtaaaccgccaa
Ccap_eve_B2_o07	cctcgtaaatcctcatcaaaCATGTAAGAAGAGGGCGTTTTTCAT
Ccap_eve_B2_e07	CTGAGGCTGAAGAGAGAGCACGTATatcatccagtaaaccgccaa
Ccap_eve_B2_o08	cctcgtaaatcctcatcaaaCTTTGCCTGTTGAAAATTGTACGGT
Ccap_eve_B2_e08	CTCTTCTCCGTTTTCAAAATATCGCatcatccagtaaaccgccaa
Ccap_eve_B2_o09	cctcgtaaatcctcatcaaaCCAAAGACGTGCATATTGTTAGCGC
Ccap_eve_B2_e09	GCGGCATACTGAACATCCATATTATatcatccagtaaaccgccaa
Ccap_eve_B2_o10	cctcgtaaatcctcatcaaaGGCATTCATTTGGTGAGGGTGGCGG
Ccap_eve_B2_e10	TGTTCATTGTTGAGTCTGAACTCGAatcatccagtaaaccgccaa
Ccap_eve_B2_o11	cctcgtaaatcctcatcaaaTCCTTTTCCAAGCGTGTCAATTGAT
Ccap_eve_B2_e11	CGAGAGACGTAGTTTTCTTTGAAGAatcatccagtaaaccgccaa
Ccap_eve_B2_o12	cctcgtaaatcctcatcaaaGATGGCGTTTATCCTTCATACGACG
Ccap_eve_B2_e12	CGGCGTAAGGCCATGCCACAGCCATatcatccagtaaaccgccaa
Ccap_eve_B2_o13	cctcgtaaatcctcatcaaaTGGGCCCGGTGCGGGATAAGGAGGA
Ccap_eve_B2_e13	CATGCCGGGCGTTGGTAACATAGGAatcatccagtaaaccgccaa
Ccap_eve_B2_o14	cctcgtaaatcctcatcaaaGGCTGCTGCATTGGTGCTGGCGGTG
Ccap_eve_B2_e14	GGTGGCATACCATGATGATGATGATatcatccagtaaaccgccaa
Ccap_eve_B2_o15	cctcgtaaatcctcatcaaaTGCCTGGTGGATAGTTTGTGGCACA
Ccap_eve_B2_e15	GTGGTGGCATCATGCCAATACCCATatcatccagtaaaccgccaa
Ccap_eve_B2_o16	cctcgtaaatcctcatcaaaTGACAGTGTGGAGGAGTTCGGCGAT
Ccap_eve_B2_e16	GGTGTGATCCGAGCCGGTTGGACTCatcatccagtaaaccgccaa
Ccap_eve_B2_o17	cctcgtaaatcctcatcaaaGGATTATGCTAATATATTCGGCGCT
Ccap_eve_B2_e17	TGGCGCTGGTGTTGTTGTGGCTCTCatcatccagtaaaccgccaa
Ccap_eve_B2_o18	cctcgtaaatcctcatcaaaATTGGCAGGCAATGGTTCGCTGTTT
Ccap_eve_B2_e18	GGTTAGGTGATGGCTCATTTCTTGGatcatccagtaaaccgccaa
Ccap_eve_B2_o19	cctcgtaaatcctcatcaaaGCGGGCGCTGGTCGCTTAACAGCCG
Ccap_eve_B2_e19	ACAACTGTCCGCTCCGCCGGTGAATatcatccagtaaaccgccaa
Ccap_eve_B2_o20	cctcgtaaatcctcatcaaaGTCACTCGGCCAACAAATTATTGTT
Ccap_eve_B2_e20	TTTTTGAGTTGTTGGCCATCAGAACatcatccagtaaaccgccaa
