Ccap_eve_B5_o01	ctcactcccaatctctataaAACACCAAGTGGGTAGGAAAAGAAT
Ccap_eve_B5_e01	GCCATGCCTTTTAGTAAATTAGTGCctaccctacaaatccaataa
Ccap_eve_B5_o02	ctcactcccaatctctataaCAACTCAAATCAGTCCCGTTTCCTT
Ccap_eve_B5_e02	CGATAAAACTGTCCGGCAAATTCATctaccctacaaatccaataa
Ccap_eve_B5_o03	ctcactcccaatctctataaGTAGACTATGGCCTCATAATGTCTA
Ccap_eve_B5_e03	AAACGACATTTCTCATAAGCCAGTGctaccctacaaatccaataa
Ccap_eve_B5_o04	ctcactcccaatctctataaGCGCAATGGGGCAATGGGAGCACAG
Ccap_eve_B5_e04	GCTTCCACCCAGCAAAATTAAGTTTctaccctacaaatccaataa
Ccap_eve_B5_o05	ctcactcccaatctctataaTACTGCGTGGCTCTTTGAAAATCGA
Ccap_eve_B5_e05	CCTTCCGAACAATTTTGATGAGGAActaccctacaaatccaataa
Ccap_eve_B5_o06	ctcactcccaatctctataaATGTCGCCATGTGTGTCTGTATGGG
Ccap_eve_B5_e06	GCAATGGAAGAGTGTCTATATGCATctaccctacaaatccaataa
Ccap_eve_B5_o07	ctcactcccaatctctataaCATGTAAGAAGAGGGCGTTTTTCAT
Ccap_eve_B5_e07	CTGAGGCTGAAGAGAGAGCACGTATctaccctacaaatccaataa
Ccap_eve_B5_o08	ctcactcccaatctctataaCTTTGCCTGTTGAAAATTGTACGGT
Ccap_eve_B5_e08	CTCTTCTCCGTTTTCAAAATATCGCctaccctacaaatccaataa
Ccap_eve_B5_o09	ctcactcccaatctctataaCCAAAGACGTGCATATTGTTAGCGC
Ccap_eve_B5_e09	GCGGCATACTGAACATCCATATTATctaccctacaaatccaataa
Ccap_eve_B5_o10	ctcactcccaatctctataaGGCATTCATTTGGTGAGGGTGGCGG
Ccap_eve_B5_e10	TGTTCATTGTTGAGTCTGAACTCGActaccctacaaatccaataa
Ccap_eve_B5_o11	ctcactcccaatctctataaTCCTTTTCCAAGCGTGTCAATTGAT
Ccap_eve_B5_e11	CGAGAGACGTAGTTTTCTTTGAAGActaccctacaaatccaataa
Ccap_eve_B5_o12	ctcactcccaatctctataaGATGGCGTTTATCCTTCATACGACG
Ccap_eve_B5_e12	CGGCGTAAGGCCATGCCACAGCCATctaccctacaaatccaataa
Ccap_eve_B5_o13	ctcactcccaatctctataaTGGGCCCGGTGCGGGATAAGGAGGA
Ccap_eve_B5_e13	CATGCCGGGCGTTGGTAACATAGGActaccctacaaatccaataa
Ccap_eve_B5_o14	ctcactcccaatctctataaGGCTGCTGCATTGGTGCTGGCGGTG
Ccap_eve_B5_e14	GGTGGCATACCATGATGATGATGATctaccctacaaatccaataa
Ccap_eve_B5_o15	ctcactcccaatctctataaTGCCTGGTGGATAGTTTGTGGCACA
Ccap_eve_B5_e15	GTGGTGGCATCATGCCAATACCCATctaccctacaaatccaataa
Ccap_eve_B5_o16	ctcactcccaatctctataaTGACAGTGTGGAGGAGTTCGGCGAT
Ccap_eve_B5_e16	GGTGTGATCCGAGCCGGTTGGACTCctaccctacaaatccaataa
Ccap_eve_B5_o17	ctcactcccaatctctataaGGATTATGCTAATATATTCGGCGCT
Ccap_eve_B5_e17	TGGCGCTGGTGTTGTTGTGGCTCTCctaccctacaaatccaataa
Ccap_eve_B5_o18	ctcactcccaatctctataaATTGGCAGGCAATGGTTCGCTGTTT
Ccap_eve_B5_e18	GGTTAGGTGATGGCTCATTTCTTGGctaccctacaaatccaataa
Ccap_eve_B5_o19	ctcactcccaatctctataaGCGGGCGCTGGTCGCTTAACAGCCG
Ccap_eve_B5_e19	ACAACTGTCCGCTCCGCCGGTGAATctaccctacaaatccaataa
Ccap_eve_B5_o20	ctcactcccaatctctataaGTCACTCGGCCAACAAATTATTGTT
Ccap_eve_B5_e20	TTTTTGAGTTGTTGGCCATCAGAACctaccctacaaatccaataa
