Ccap_eve_B4_o01	cctcaacctacctccaacaaAACACCAAGTGGGTAGGAAAAGAAT
Ccap_eve_B4_e01	GCCATGCCTTTTAGTAAATTAGTGCtctcaccatattcgcttcat
Ccap_eve_B4_o02	cctcaacctacctccaacaaCAACTCAAATCAGTCCCGTTTCCTT
Ccap_eve_B4_e02	CGATAAAACTGTCCGGCAAATTCATtctcaccatattcgcttcat
Ccap_eve_B4_o03	cctcaacctacctccaacaaGTAGACTATGGCCTCATAATGTCTA
Ccap_eve_B4_e03	AAACGACATTTCTCATAAGCCAGTGtctcaccatattcgcttcat
Ccap_eve_B4_o04	cctcaacctacctccaacaaGCGCAATGGGGCAATGGGAGCACAG
Ccap_eve_B4_e04	GCTTCCACCCAGCAAAATTAAGTTTtctcaccatattcgcttcat
Ccap_eve_B4_o05	cctcaacctacctccaacaaTACTGCGTGGCTCTTTGAAAATCGA
Ccap_eve_B4_e05	CCTTCCGAACAATTTTGATGAGGAAtctcaccatattcgcttcat
Ccap_eve_B4_o06	cctcaacctacctccaacaaATGTCGCCATGTGTGTCTGTATGGG
Ccap_eve_B4_e06	GCAATGGAAGAGTGTCTATATGCATtctcaccatattcgcttcat
Ccap_eve_B4_o07	cctcaacctacctccaacaaCATGTAAGAAGAGGGCGTTTTTCAT
Ccap_eve_B4_e07	CTGAGGCTGAAGAGAGAGCACGTATtctcaccatattcgcttcat
Ccap_eve_B4_o08	cctcaacctacctccaacaaCTTTGCCTGTTGAAAATTGTACGGT
Ccap_eve_B4_e08	CTCTTCTCCGTTTTCAAAATATCGCtctcaccatattcgcttcat
Ccap_eve_B4_o09	cctcaacctacctccaacaaCCAAAGACGTGCATATTGTTAGCGC
Ccap_eve_B4_e09	GCGGCATACTGAACATCCATATTATtctcaccatattcgcttcat
Ccap_eve_B4_o10	cctcaacctacctccaacaaGGCATTCATTTGGTGAGGGTGGCGG
Ccap_eve_B4_e10	TGTTCATTGTTGAGTCTGAACTCGAtctcaccatattcgcttcat
Ccap_eve_B4_o11	cctcaacctacctccaacaaTCCTTTTCCAAGCGTGTCAATTGAT
Ccap_eve_B4_e11	CGAGAGACGTAGTTTTCTTTGAAGAtctcaccatattcgcttcat
Ccap_eve_B4_o12	cctcaacctacctccaacaaGATGGCGTTTATCCTTCATACGACG
Ccap_eve_B4_e12	CGGCGTAAGGCCATGCCACAGCCATtctcaccatattcgcttcat
Ccap_eve_B4_o13	cctcaacctacctccaacaaTGGGCCCGGTGCGGGATAAGGAGGA
Ccap_eve_B4_e13	CATGCCGGGCGTTGGTAACATAGGAtctcaccatattcgcttcat
Ccap_eve_B4_o14	cctcaacctacctccaacaaGGCTGCTGCATTGGTGCTGGCGGTG
Ccap_eve_B4_e14	GGTGGCATACCATGATGATGATGATtctcaccatattcgcttcat
Ccap_eve_B4_o15	cctcaacctacctccaacaaTGCCTGGTGGATAGTTTGTGGCACA
Ccap_eve_B4_e15	GTGGTGGCATCATGCCAATACCCATtctcaccatattcgcttcat
Ccap_eve_B4_o16	cctcaacctacctccaacaaTGACAGTGTGGAGGAGTTCGGCGAT
Ccap_eve_B4_e16	GGTGTGATCCGAGCCGGTTGGACTCtctcaccatattcgcttcat
Ccap_eve_B4_o17	cctcaacctacctccaacaaGGATTATGCTAATATATTCGGCGCT
Ccap_eve_B4_e17	TGGCGCTGGTGTTGTTGTGGCTCTCtctcaccatattcgcttcat
Ccap_eve_B4_o18	cctcaacctacctccaacaaATTGGCAGGCAATGGTTCGCTGTTT
Ccap_eve_B4_e18	GGTTAGGTGATGGCTCATTTCTTGGtctcaccatattcgcttcat
Ccap_eve_B4_o19	cctcaacctacctccaacaaGCGGGCGCTGGTCGCTTAACAGCCG
Ccap_eve_B4_e19	ACAACTGTCCGCTCCGCCGGTGAATtctcaccatattcgcttcat
Ccap_eve_B4_o20	cctcaacctacctccaacaaGTCACTCGGCCAACAAATTATTGTT
Ccap_eve_B4_e20	TTTTTGAGTTGTTGGCCATCAGAACtctcaccatattcgcttcat
